我还看了一个口碑不错的电影叫星际穿越给我的感觉超棒	有一部电影最后一支舞你可以看一下。好的有时间我看看吧。我还看了一个口碑不错的电影叫星际穿越给我的感觉超棒。
明星宋承宪代表作浪漫风暴挺好的一个明星推荐你关注	你有关注韩国的明星吗。有啊韩国首尔的都有关注。明星宋承宪代表作浪漫风暴挺好的一个明星推荐你关注。
大红灯笼高高挂是很有才华感觉和别的导演色彩都不一样	哎呀不行我要再去看看大红灯笼高高挂怀念一下。经典就是经典这部电影的导演太厉害了还在1998年捧获威尼斯金狮奖呢。是很有才华感觉和别的导演色彩都不一样。
那我去看看火龙对决是不是有真龙	我不信你信。看了火龙对决这部电影我感觉龙是真实存在的推荐给你看看你就信了。那我去看看是不是有真龙。
你有臭袜子	你袜子好臭。我没有臭袜子。你有。
我也是我超喜欢上帝之城里面的费尔南多梅里尔斯超级眩镜头干净利落估计拍了不少的广告和mv	那你一定知道上帝之城获得了东京国际电影节大奖的提名咯。当然啦这电影我看了好几遍的。我也是我超喜欢里面的费尔南多梅里尔斯超级眩镜头干净利落估计拍了不少的广告和mv。
没有ios好	安卓好用吗。你评价一下安卓。没有ios好。
戴思杰导演的电影不错呢我很喜欢戴思杰导演的电影	你喜欢谁导演的电影呢。我喜欢安东尼罗素和乔罗素他们导演的电影。戴思杰导演的电影不错呢我很喜欢。
呼和浩特明天气温有点低	明天气温多少度。呼和浩特明天最高温度27度最低温度14度气温宜人和好朋友一起出去玩吧。气温有点低。
妙手情真这么大义凛然的剧吗还献身	什么剧。妙手情真讲一个医生为医学献身的故事。这么大义凛然的剧吗还献身。
我小时候看的芭比电影也是	美女与野兽找她拍太合适。迪斯尼电影很多都是那种演着演着就唱起来的。我小时候看的芭比电影也是。
海洋导演是雅克贝汉	这是部剧情类型的电影还有一部也是剧情类的电影推荐给你。片名是什么。海洋导演是雅克贝汉。
处女座有多严重呀	处女座有洁癖。是的。你有多严重呀。
小鼓用了什么工艺	古琴用了什么工艺。1.选择制作古琴的材料;2.在古琴材料上用铅笔画出琴体的形状大小,画出琴徽的各处龙池凤沼的位置;3.用斧子和刨刀刨出一个有弧度的古琴面板形状,做出槽腹、底板和古琴附件;4.对古琴材料进行刮灰胎和对琴体上漆;5.对古琴上弦和进行调音。。小鼓呢。
小姐姐叫赵今麦呢	是啊我最近好喜欢一位小姐姐她好厉害的呢。是谁啊。她叫赵今麦呢。
戴志斌是男人就应该付钱	戴志斌是不是你。戴志斌是男人。他是男人就应该付钱。
黑衣3	那我们去看前些年上映的外国片。要得片子名叫什么。黑衣人3。
你旧时光主题曲是什么	你好旧时光。小说你好旧时光主题曲。是什么。
原来是迪安德夫林啊这下我知道了	这个我还真不知道呢能告诉我叫什么名字吗。叫迪安德夫林他的独立日提名过1997年第23届土星奖土星奖最佳编剧。原来是他啊这下我知道了。
我爱的人在卫生间吗	我爱的人在哪里。在你隔壁.利物浦哈哈。他在卫生间吗。
你看过我最好朋友的婚礼吗	谁是我最好朋友的婚礼的导演。影视信息早知道，小布帮你查到《我最好朋友的婚礼》的导演是陈飞宏哦，要不要一起看看这部剧呢？。你看过吗。
哈哈你说的是吴孟达达叔吧吴孟达达叔是周星驰的固定配角呢	特别喜欢周星驰的电影是陪伴我童年的经典呀。我也特别喜欢他而且总是有固定的高演技演员一起觉得很温馨。哈哈你说的是吴孟达达叔吧他是周星驰的固定配角呢。
好的抽时间去看看姐姐的守护者	没有看。名字是姐姐的守护者咱们明天上午一起看看吧。好的抽时间去看看。
艾力克托兰达导演的名字我就不太知道了	是啊国外的有些电影确实是好看啊。是的不知道你认不认识一位导演叫艾力克托兰达。导演的名字我就不太知道了。
火影忍者讲来听听	你看动漫吗。火影忍者。讲来听听。
不可能你长的这么漂亮	你有男朋友了吗。要是我说没有你会相信嘛。不可能你长的这么漂亮。
达斯汀霍夫曼达斯汀霍夫曼被称为影帝	这是一部口碑不错的爱情电影电影里有位演员我很喜欢。谁啊。达斯汀霍夫曼他被称为影帝。
r3说他说有电	袋鼠的弱点。不会倒退往回走只能掉头。r3说他说有电。
你哥不是有关领导的原则	你哥那个呢。追星女孩的世界遍地都是哥哥。他不是有关领导的原则。
对啊而且吴甜甜还演了不少电影	哇我看那个吴甜甜居然这么小这么优秀了。这是一个演员嘛。对啊而且还演了不少电影。
百年孤独的作者是谁	你知道百年孤独吗。怎么说呢伟大但是令人恐惧无法摆脱的孤独与无力梦想与激情皆成泡影说实话这小说不适合我你喜欢。它的作者是谁。
你说的中国幽默人物的领头羊是谁啊	我一定认真看。这部电影里面的男主演演技很好网友们都说他是中国幽默人物的领头羊哈哈。你说的是谁啊。
很久之前的复仇者联盟应该是第一部吧	复仇者联盟你有看过吗。看过啊那是很久之前了。很久之前的应该是第一部吧。
好有意思的电影名字	喜欢啊你知道有什么好看的么。我最喜欢大明猩这部电影。好有意思的电影名字。
薛之谦是靠自己	薛之谦。我觉得薛之谦成为段子手才红的。他是靠自己。
那你肯定知道陈楚河陈楚河在你们学院进修过	你知道中国文化大学吗。知道我就是那里毕业的。那你肯定知道陈楚河他在你们学院进修过。
护垫侠的名字感觉很奇葩啊	就喜欢剧情类型的电影你快说说吧。这部电影叫护垫侠是r巴尔金导演的。这部电影的名字感觉很奇葩啊。
哈哈哈对对极品基老伴名字比较像基佬是伊恩麦克莱恩演的哦	对啊你看过极品基老伴啊。没有看过但是听名字就感觉是英国的。哈哈哈对对名字比较像基佬是伊恩麦克莱恩演的哦。
何晴是解放军艺术学院戏剧系艺术硕士毕业	一定记住了。何晴是中国浙江的一个女孩血型是o型我知道的多吧。厉害我就很弱了我只知道她是解放军艺术学院戏剧系艺术硕士毕业。
发送想额娘啦	给额娘发短信。你要发送什么内容？。发送想她啦。
他告诉你去吧多吃点他说	我还是说他要吃饭。去吧多吃点。他告诉你去吧多吃点他说。
我见过siri	那你认识SIRI吗。怎么突然提起她了，我吃醋啦。。我见过他。
影子写手是谁的代表作还真不知道	前几天刚看了影子写手还是和朋友一块看的呢。那你知道这部电影是谁的代表作吗。这个还真不知道。
找我爱的人复合前做出一些改变	我是女生想把我爱的人追回来。怎么追。找他复合前做出一些改变。
杭州有家啥呀	杭州哪里东西好吃。下沙有家呀。有家啥呀。
哪部电影	倪萍是奶奶了不过我很喜欢她。还有一部网评说鸡皮疙瘩掉一地的电影我觉得很好看推荐给你吧。哪部电影。
我还真是不关注啊那凌潇肃现在和谁一起呢	凌潇肃不适合姚晨吗。早就离婚了呀你能不能紧跟八卦潮流。我还真是不关注啊那他现在和谁一起呢。
没看过一路向前只是听朋友提起过	你说的是哪一部电影呢。电影名字叫一路向前网上评论说应该是一部喜剧片看片花觉得很有感触。没看过这部影片只是听朋友提起过。
什么时候才能多几个跟蔡少芬一样厉害的演员啊	现在好看演技又好的演员真的是越来越少了。对啊毕竟现在都是靠脸的。什么时候才能多几个跟蔡少芬一样厉害的演员啊。
你看过证人吗	谢霆锋演的证人什么时候上映。小布在手，资讯全有。《证人》于2008年正式上映。。你看过吗。
这么巧啊空之境界电影版第二章杀人考察前的主演谁啊	既然是动画片我就去看看空之境界电影版第二章杀人考察前谢谢了。这部剧的主演跟你还是一个院校毕业的也是桐朋学园大学短期大学。这么巧啊谁啊。
王欣是快播老板	王欣。王欣是谁。是快播老板。
宇宙是什么	请你科普一下宇宙。帮我科普一下。是什么。
纯真年代男主角还演过什么电影	申河均在纯真年代扮演的是谁。申河均在纯真时代中饰演的是金闵宰。男主角还演过什么电影。
让熊猫飞我看过感觉还行啊就是不知道让熊猫飞在表达什么	我感觉挺好啊。可能每个人的想法都不一样吧他演了一部让熊猫飞的电影是关于熊猫的。让熊猫飞我看过感觉还行啊就是不知道他在表达什么。
我们也是其他的	我不开心。何以解忧唯有暴富。我们也是其他的。
是么	你是冰洁么。自带光环。是么。
是滴洛克王国3圣龙的守护还是蛮好看的	是的2014年7月10号上映的洛克王国3圣龙的守护。嗯虽然定位很低龄化但制作还是比较精良的支持一下。是滴还是蛮好看的。
蒂姆波顿是谁啊	你这一说蒂姆波顿我也想起来啦。他还有个口碑不错的好友。是谁啊。
电影重返20岁我还没看过	是不是就是那个重返20岁那个主题曲。对对对就是杨子姗演的那个剧中超级美丽。电影我还没看过。
祈祷落幕时不过祈祷落幕时口碑一般	还有一部电影也很不错呢2018年1月27日上映的。什么电影说出来听听。祈祷落幕时不过口碑一般。
没时间去看医生呢	最近感觉嘴巴好苦。病的厉害吗去看医生了吗。没时间去呢。
你跳一个舞	跳个舞吧。我想看钢管舞。你跳一个。
没有看唐人街探案2怎么看2呀	你看了唐人街探案1了。看了呀。没有看怎么看2呀。
他学网	我比你好看。我比你好看。他学网。
你醒了我问他你在哪儿	你在哪。一直在你心里。你醒了我问他你在哪儿。
是吗那我一定要去看看一轮明月的	不知道啊哪一部。一轮明月主角一生的经历非常让人感动去看看吧说不定会引起心灵上的共鸣呢。是吗那我一定要去看看的。
可以呀我有时间就去看一下定格爱情小故事	看过穿条纹睡衣的男孩。给你推荐一部carloslascano导演的电影名字定格爱情小故事有时间可以去看一下。可以呀我有时间就去看一下。
阿黄曼他	你可以帮我打电话吗。你要打给谁呢。阿黄曼他。
我媳妇在这呢你跟他说两广吧	小布小布。被你喊过的名字叫泡芙都很甜什么事。我媳妇在这呢你跟他说两句话吧。
保罗柯艾略写过什么书	保罗柯艾略的代表作是什么。保罗柯艾略的书充满哲学气息很喜欢。他写过什么书。
小威怎么了你怎么吃醋了	你认识小威吗。怎么突然提起她了我吃醋啦。他怎么了你怎么吃醋了。
好的我喜欢悬疑类型的电影	最近没怎么看电影你有什么推荐吗。有一部悬疑类的电影叫京城81号2可以了解一下。好的我喜欢悬疑类型的。
我想他了然后好几年不联系了	是见不到他。慢慢找总会找到的。我想他了然后好几年不联系了。
赵丽颖是挺好的以前看陆贞传奇的时候挺喜欢赵丽颖的	你有什么喜欢的内地女演员吗。我觉得赵丽颖挺好的。她是挺好的以前看陆贞传奇的时候挺喜欢她的。
甄子丹的隐私部位	甄子丹演的很假。观众的喜恶是自由的，对甄子丹不感兴趣不如问问其他演员？。他的隐私部位。
我要打给孩子他妈	我要打电话。你要打给谁呢？。我要打给孩子他妈。
木小雅是一个独立音乐人	你知道木小雅吗。所以说小雅是谁。她是一个独立音乐人。
哇你能给我讲讲龙族吗	你看过龙族吗。当然了姐是小说控。哇你能给我讲讲吗。
老人与海就是很不错的一部电影主要是导演很棒有评论说导演用油画的方式太震撼了	有机会你可以看下电影老人与海。好的应该也很不错的。就是很不错的一部电影主要是导演很棒有评论说他用油画的方式太震撼了。
金厉旭丑不丑	金厉旭喜欢的动漫人物是什么。动漫人物千千万，金厉旭喜欢谁就换，追星就追星，不要太追细节啦。。他丑不丑。
盗贼和猎人当然好玩	最近盗贼输出挺高。盗贼和猎人比谁后期输出高啊大家觉得盗贼好玩不。当然好玩。
专柜的多少钱	好啊 多少钱。专柜的价钱呢。多少钱。
他离开我了怎么办	聊聊天呗。真巧小布也想陪你聊天呢。他离开我了怎么办。
刚看了深红累之渊下个月才上映呢	悬疑片深红累之渊不知道是否上映了。那我们去查一下。刚看了下个月才上映呢。
嗯嗯是的我前几天还看了惠天赐另一部已经上映的电影很不错呢	你看过惠天赐演的古装片吗就是那个满族的。惠天赐是那个狮子座的男星吗。嗯嗯是的我前几天还看了他另一部已经上映的电影很不错呢。
大厦将倾名字还挺好听可以去看一下	他主演的电影应该好多吧你说的是哪一部。电影名字是大厦将倾。这个名字还挺好听可以去看一下。
葛优可是娱乐圈里靠谱的好男人葛优还获得过三届大众电影百花奖最佳男主角	他的搭档葛优你知道吗。知道啊看过他的不少作品呢。他可是娱乐圈里靠谱的好男人还获得过三届大众电影百花奖最佳男主角。
喜欢炎亚纶什么歌	炎亚纶咋啦。小学开始就喜欢炎亚纶的歌。喜欢他什么歌。
泡面没营养	泡面不好吃。好吃不贵放在微波炉里三分钟就好懒癌发作时候的必备良品了。没营养。
你还爱他吗	你还爱他吗。别问问就是爱过。你还爱他吗。
那就改到今天吧	明天安排你去相亲吧。我们这里的风俗是正月不能相亲啊。那就改到今天吧。
没看过变形金刚	你说的变形金刚吗。不是是portraitsofsari真的不怎么样。没看过。
没听过田中秀幸不过可以了解一下田中秀幸	我还真不知道。田中秀幸体重71kg身高172cm她是很棒的演员。没听过不过可以了解一下。
心怎么转移注意力	心好烦。心烦的时候就要转移下注意力。怎么转移。
我他妈问我助手呢	什么是傻逼。不好意思这个问题超纲了哦。我他妈问我助手呢。
请把生命交给我听起来不错哦	是什么爱情片我也去看看。电影叫请把生命交给我。听起来不错哦。
你他妈要干什么	我想骂你。心情不好吗。你他妈要干什么。
倪虹洁主演的约会大师之爱在响螺湾今年已上映有看过吗好像评论不怎么好	你知道倪虹洁吗。还不太清楚说来听听。她主演的约会大师之爱在响螺湾今年已上映有看过吗好像评论不怎么好。
哦是吗李学生听着应该不错吧	什么名字。电影名叫李学生演绎生前英勇救人的真实事迹和感人故事。哦是吗听着应该不错吧。
第一大案斯琴高娃在里边也是主演你可以看看	那我给你介绍一部她主演的电影吧沈悦导演的。好的你说吧。第一大案斯琴高娃在里边也是主演你可以看看。
打给他	打电话给。你要打给谁呢。打给他。
不认识叶全真	看脸咯。叶全真就是有脸蛋还性感。不认识这个明星。
金瓶梅的作者是谁	你知道金瓶梅吗。看过了只记得情节了。它的作者是谁。
你这话被小爱同学知道了小爱同学会生气的	那你认识小爱同学吗。小布觉得她肯定没有小布可爱。。你这话被她知道了她会生气的。
我不怎么喜欢娃娃脸	娃娃脸你觉得好看吗。我很喜欢这类型的女人。我不怎么喜欢。
你他妈就是傻	你他妈就是傻。在这种场合说这个话，不太合适吧？。你他妈就是傻。
我喜欢非常幸运的名字	肯定啊除非有什么非常经典的作品出来。她还有一部代表作叫非常幸运还是一部喜剧类型的电影呢。我喜欢这个名字。
觉得可塑性记忆怎么样	看过可塑性记忆吗。尽管大家都推荐说是很感人可并不喜欢人物风格设定剧情也是回忆杀强行催泪。觉得怎么样。
窝窝头微信上给他发个傻逼	小布小布。你的小宝贝正向你奔来。说吧什么事？。窝窝头微信上给他发个傻逼。
古筝有什么部件	编钟有什么部件。编钟的组成：编钟由大小不同的扁圆钟按次序排列，悬挂在钟架上。。古筝呢。
ladygaga还演过一部电影呢不过还没有上映	那你一定要听一听ladygaga的音乐很好听。听不懂我还是喜欢中国的流行歌曲。她还演过一部电影呢不过还没有上映。
我最喜欢巨蟹座了很居家	那咱们聊聊星座吧你好奇心那么重是水瓶座还是射手座。不是啊我是巨蟹座。我最喜欢这个星座了很居家。
你认识小爱吗	小布你认识小爱吗。一生一世一心人，怎么突然提起别人？。你认识他吗。
白金之星是傻么	你知道白金之星吗。这个都知道啊！。他是傻么。
21克拉这是一部爱情类的电影	不过呢她在电影里面表现还是不错的大家都说她演得很好。什么电影啊我也去看看她到底演得怎么样。21克拉这是一部爱情类的电影。
那就要推荐你看一下荒漠游侠这部剧啦沙漠游侠很适合你的	你喜欢什么类型的电影呢。最喜欢武打类型。那就要推荐你看一下荒漠游侠这部剧啦很适合你的。
什么周旭薇导演的电影	嗯她还拍了绿光森林也没火起来。而且他还拍了一部周旭薇导演的电影。什么电影。
你华晨宇妈你给我播放啊	华晨宇唱的大圣。我也喜欢这个。你他妈你给我播放啊。
田雨老师好像跟汤唯过一段感情吧	虽然是个配角但是还不错吧他好像也出演过小丈夫吧。是啊田雨老师也有不少作品。他好像跟汤唯有过一段感情吧。
莫少聪还演过一部电影不过口碑很差你知道是哪部吗	他叫莫少聪香港人当年他特火。对啊好像真的最近都听不到怎么议论他了当年我也喜欢他呢。莫少聪还演过一部电影不过口碑很差你知道是哪部吗。
地球的半径多大	地球的直径是多少千米。地球的直径为12756 km。。它的半径多大。
不太了解姜超	不太喜欢。姜超你知道吗。不太了解。
你不知道陈佩斯真的老逗了	啊啊想起来了叫陈佩斯老逗乐了。看把你乐的有那么好笑吗。你不知道真的老逗了。
黑吃黑到底叫什么名字啊	黑吃黑男主角到底叫什么啊。就这样结束了从第一集开始追了四年的美剧完结了就好像谈了四年的恋爱突然分手了好惆怅。他到底叫什么名字啊。
时光网短评厕所爱情故事说厕所爱情故事里面的钢琴配的非常牵动人心你知道厕所爱情故事的导演是谁吗	获得2009年第81届奥斯卡最佳动画短片提名的厕所爱情故事。嗯厕所爱情有点意思。时光网短评说里面的钢琴曲配的非常牵动人心你知道这部电影的导演是谁吗。
siri说他想和我分手	嘿SIRI。一生一世一心人，怎么突然提起别人？。他说他想和我分手。
佐久间丽是人才吗	佐久间丽电影。还没见识过佐久间丽的演技。金子总会发光的，有我有你，佐久间丽未来可期。。他是人才吗。
李洋怎么样是不是听说过	电影是一个汉族的双子座的导演导的。你说的哪位。李洋怎么样是不是听说过。
我觉得张继聪就很不错	现在有些配角真的很不错。谁配角更好一些。我觉得张继聪就很不错。
好的抽空关注一下常征	哪位啊。常征他和你一样都是处女座的呢。好的抽空关注一下。
我记得杰弗里拉什很不错的一位演员	你说的谁啊我看看认识不。他叫杰弗里拉什是澳大利亚的。我记得他很不错的一位演员。
喜欢陈粒的什么歌	知道陈粒嘛。粒粒好火。喜欢她的什么歌。
是啊朱莉娅罗伯茨在电影我最好朋友的婚礼里面还提名了	名字叫朱莉娅罗伯茨。她的口碑好像很好。是啊她在电影我最好朋友的婚礼里面还提名了。
我喜欢他他却不喜欢我	真的很喜欢他。他可能真的有点喜欢你，但也不耽误他喜欢别人。。我喜欢他他却不喜欢我。
烧郎红听名字就很有趣	没关注过以后会关注的。王渝文还主演过一部电影叫烧郎红我感觉还可以哦。听名字就很有趣。
妖神记更新时间	妖神记。妖神记是发飙的蜗牛向玄幻题材的转型作品啊。更新时间。
嗝嗝老师今年也会上映	好看的我肯定做过功课啦。相信你啦。嗝嗝老师今年也会上映。
已经看过俄罗斯女歌手了	你说的是哪一部。俄罗斯女歌手挺不错看了别害怕。已经看过了。
没关注过托妮科莱特	好的。托妮科莱特的主演哦你认识这位大美女吗。没关注过。
给我讲故事吗我叫他发了一张	我今天特别难过。人生不就是关关难过关关过吗。给我讲故事吗我叫他发了一张。
到时候我也跟他说过话呢	小布给我唱首歌。发生什么了呢。到时候我也跟他说过话呢。
你问小爱	小爱。一生一世一心人，怎么突然提起别人？。你问他。
哦潘长江是国家一级演员网友评论潘长江是个很好的喜剧演员呢	这部戏里还有一位演员叫潘长江你肯定知道吧。恩恩我知道他他的所有作品我都看过。哦他是国家一级演员网友评论是个很好的喜剧演员呢。
好的影舞者没问题	你说的是哪一部电影。影舞者你也可以看看。好的没问题。
夜魔人是一部国产影片导演是张坤一我觉得你不会喜欢夜魔人的	杜玉明还主演过一部电影叫夜魔人但是网评不太好哦。我是第一次听说这个影片。是一部国产影片导演是张坤一我觉得你不会喜欢的。
请问张颜齐火起来的原因是啥	张颜齐喜欢什么。张颜齐真神秘，小布搜遍也找不到相关信息，但小布确定，张颜齐喜欢的东西里一定有一样，是作为粉丝的你。。请问他火起来的原因是啥。
我也是醉的味道	我喝完咖啡 像喝醉一样 哈哈。很喜欢coffee的味道。我也是。
你抱的动吗	詹姆斯。总有人想黑我家詹姆斯悄悄抱走不谢。你抱的动吗。
我也想喝可乐	想喝阔落。我想喝可乐。我也想。
中条彩未离婚	谁的老公是中条彩未。娱乐圈六人定律：任何两个人之间的关系带，基本确定在六个人左右。看看中条彩未的人际网，说不定你和爱豆的距离就差一个邻居。。他离婚。
给你介绍一个邢佳栋这才是真正的纯爷们	喜欢明星吗。喜欢啊彭于晏。给你介绍一个邢佳栋这才是真正的纯爷们。
多甫拉托夫还获得柏林国际电影节银熊奖杰出艺术贡献奖呢	多甫拉托夫就是剧情类的你可以看一下。看过了很不错的电影。这部影片还获得柏林国际电影节银熊奖杰出艺术贡献奖呢。
刘立威他是傻逼不	小布小布。被你喊过的名字叫泡芙都很甜什么事。刘立威他是傻逼不。
想办法写出来年终总结	会写年终总结吗。写总结 写不出来   写不出来  写不出来。想办法写出来。
这都不知道卢巧音听说过吗	在娱乐圈心系运动的明星知道谁吗。不知道你能告诉我吗。这都不知道卢巧音听说过吗。
哦重返地球的导演是谁啊	嗯嗯我会去看重返地球的谢谢。不客气我给你介绍一下这部电影的导演吧也是狮子座的。哦是谁啊。
克里斯托弗瓦尔兹说名字我就知道了	他到底叫什么名字。他的名字叫克里斯托弗瓦尔兹。说名字我就知道了。
还有一个美国动画片也很看介绍给你	是啊要一起去看吗。好啊。还有一个美国动画片也很看介绍给你。
还有部电影叫叶问3还是叶伟信导演的作品很精彩哦	对啊我也非常喜欢给你推荐一部吧叫消失爱人有时间你可以去看看。好的可以。还有部电影叫叶问3还是叶伟信导演的作品很精彩哦。
叶璇挺厉害的	哇真的啊。是啊说叶璇才女一点都不过分叶璇得过49届英特尔国际科学与工程大奖赛植物学学科一等奖呢。挺厉害的。
笛子是什么乐器	小鼓。小鼓，是棰击膜鸣乐器。分布流行在广西、贵州、云南、湖北、湖南等省区。小鼓多用于民间，过年过节时使用。。笛子呢。
我想让他回来	可是我很爱他。他可能真的有点喜欢你，但也不耽误他喜欢别人。。我想让他回来。
我马上去欣赏一下父女情深	听父女情深名字应该挺感人的。历史评分是前50在第54届英国电影和电视艺术学院奖中获得了电影奖的最佳动画短片。我马上去欣赏一下。
他骂你啊	你个作死是。这年头永远不缺作死的人。他骂你啊。
这么厉害那我得多多关注下理查兹塞隆了	那我得去看看了不能错过好电影啊。主演查理兹塞隆在影片里面表现可圈可点毕竟她是一位评分89的实力演员还获得过第76届奥斯卡金像奖最佳女主角奖呢。这么厉害那我得多多关注下这位演员了。
地球为什么围着太阳转	太阳为什么东升西落。这是由地球自转决定的。生活在地球上的人,往往感觉不到地球自转。在地球自转时,总觉得太阳是从东方升起,向西方落下。严格说来,地球并非每天都是东升西落。。地球为什么围着它转。
三浦友和和尼查坤勒威查固最近发生了什么	三浦友和和尼查坤抔勒威查固谁更帅。见到三浦友和和尼查坤抔勒威查固之后小布发现，原来高颜值也可以这样具体！你觉得呢？。他最近发生了什么。
去过大熊猫了	旅游去哪儿。成都去看大熊猫还有很多好吃的。去过了。
杀阡陌爱上花千骨	花千骨。花千骨好漂亮我喜欢。杀阡陌爱上。
报童传奇谁主演的啊	噢哪个国家的啊。美国的叫报童传奇挺有意思的。谁主演的啊。
那你知道海豚湾是谁的代表作吗海豚湾的导演祖籍是澳大利亚维多利亚墨尔本	海豚湾记录了日本太地町当地的渔民每年捕杀海豚的经过。其实这也正是纪录片的意义让我们能知道更多我们去不到的地方发生过或者发生着的故事。那你知道这部纪录片是谁的代表作吗她祖籍是澳大利亚维多利亚墨尔本。
最喜欢哪一首泰勒	泰勒的听过吗。很喜欢泰勒。最喜欢哪一首。
行运一条龙女主角还演过什么	行运一条龙周星驰演的是谁。周星驰在剧中饰演何金水，剧本身已经足够好看，比剧情更好看的是周星驰的演技。。女主角还演过什么。
让他先别着急过来	可能我生气了。别生气了我给你笑一个嘻嘻。让他先别着急过来。
邓紫棋有什么作品呢	你知道邓紫棋吗。邓紫棋是一个很有潜力的音乐人。有什么作品呢。
给他爸爸	请打个电话吧。你要打给谁呢？。给他爸爸。
电影名字叫不需要邮费	是美国的。电影叫什么名字。名字叫不需要邮费。
什么电影会让你有这样的感慨	对呀就是他呀长得帅吧。人长的好看演的电影特别催泪。什么电影会让你有这样的感慨。
他想起我的家里做	你去哪里啦。东风夜放花千树我想去你家里住。他想起我的家里做。
他要是五千米那么好	不过你好可爱呀。不不不你更可爱一点。他要是五千米那么好。
要不你跟我一起看变态杀人魔吧	是什么恐怖片啊。叫变态杀人魔。要不你跟我一起看吧。
看新欢乐满人间的名字应该是一部很轻松的片子等上映了我就去看新欢乐满人间	是什么啊快点告诉我呀。新欢乐满人间今年将会上映等上映了你可以去看看。看名字应该是一部很轻松的片子等上映了我就去看。
杨永信是精神科医生	你知道杨永信吗。嗯嗯   是的。他是精神科医生。
秦昊主演了一部中国电影叫唐布拉之恋很好看的呢	对啊我觉得秦昊真的很厉害。那可不毕竟是真的实力派啊又有颜值的。他主演了一部中国电影叫唐布拉之恋很好看的呢。
没有馒头花卷饺子好吃	这就是面包Facepalm。这就是新鲜的面包。没有馒头花卷饺子好吃。
我的建筑师真的好看啊	不知道你真的要看看我的建筑师这个电影。真的那么好看吗你都念叨一下午了。真的好看啊。
我还没看过双面天才好看吗	好的吧我会了解她的。嗯嗯她长得可漂亮了电影双面天才就是埃米罗森主演的呢电影很不错哦。我还没看过这部电影好看吗。
命运冠位指定是游戏	命运冠位指定呢。命运冠位指定一直在我的播放列表里隔段时间就要听听。它是游戏。
聊我喜欢的没用呀他不喜欢呀	那你能不能告诉我怎么聊呀。当然是聊你喜欢的啦。聊我喜欢的没用呀他不喜欢呀。
看来谷德昭很厉害啊	导演是谁啊这么有才。他叫谷德昭获得过第7届香港电影金紫荆奖最佳编剧奖。看来他很厉害啊。
你知道他是干什么的吗	你为什么认识他。那是当然你终于知道我有多厉害了吧。你知道他是干什么的吗。
我之前看过地狱为何恶劣了	地狱为何恶劣中国村隼有没有参演。国村隼在《地狱为何恶劣》里饰演武藤大三。我之前看过了。
日本的宫田早苗不知道你了解不了解	转转的导演是三木聪这个导演我还蛮喜欢的。这个导演听说过的这个电影都有谁出演了啊。日本的宫田早苗不知道你了解不了解。
婷婷有男朋友吗	婷婷是谁。是我的唯一。她有男朋友吗。
路易斯曼多奇路易斯曼多奇是1954年的	这部电影的导演和你一样都是墨西哥墨西哥城的呢。这么巧啊谁啊。路易斯曼多奇他是1954年的。
哦高天鹤帅吗	高天鹤呢。是天津歌舞剧院歌剧团歌剧演员。哦他帅吗。
那倒是毕竟听不懂英语嘛还有什么英国的电影推荐吗我想试试能不能看懂哈哈	那我要好好研究研究喽。至暗时刻是英国的电影啊咱们没看懂情有可原哈哈。那倒是毕竟听不懂英语嘛还有什么英国的电影推荐吗我想试试能不能看懂哈哈。
只跟我妈妈说	你叫我妈妈。爬坡很累风景很美这条路小布陪你。只跟他说。
对啊最近有孙立军的配音的那部兔侠传奇动画片兔侠传奇是相当的火呢	孙立军就是动漫前进的毒瘤。原来他是天秤座的啊。对啊最近有他的配音的那部兔侠传奇动画片那是相当的火呢。
啊是吗是哪一位导演啊	是呢快给小公主看吧。这部电影的导演还和你一个地方的都是英国北爱尔兰的人。啊是吗是哪一位导演啊。
在四个丘比特里有个人是双子座的你知道是谁吗	名字叫四个丘比特很不错给你推荐一下。好的回家后我就看看谢谢推荐。在这部电影里有个人是双子座的你知道是谁吗。
什么20年前上映的老电影呢	感觉应该可以。准备看一部20年前上映的老电影主演就是他。什么电影呢。
你喜欢小罗伯特唐尼吗	小罗伯特唐尼怎么样啊。哎呦喂。你喜欢他吗。
科目二没考呢	你科目二过了吗。科目四是啥。没考呢。
柯林法瑞尔绝对的演技派知道柯林法瑞尔吗	喜欢偶像派还是演技派。都喜欢吧。柯林法瑞尔绝对的演技派知道他吗。
你说得不对刘佳渝不是宠物刘佳渝是一个帅哥	刘佳渝这个人认识吗。说到宠物让我想到一个蠢萌的贴子。你说得不对他不是宠物他是一个帅哥。
每次听曲子大提琴的声音总能被我听出来哦	听 ja 音乐时还真喜欢大提琴。大提琴音色很好的。每次听曲子它的声音总能被我听出来哦。
王博雅是谁	认识王博雅吗。我选了博雅 觉得博雅好。他是谁。
哪一部电影啊	哈哈哈那么夸张不过他的生意真的好有磁性好听。对啊很好听的那你知道他在2014年10月1日上映的那部电影吗。哪一部啊。
周友朝导演的预审很不错	预审就是他主演的呢看过吗。还没看过好看吗。周友朝导演的很不错。
火星是什么颜色的	火星的样子。火星表面的颜色是红色的，所以火星有时被称为“红色行星”。火星以二氧化碳为主，没有稳定的液态水，有高地，亦有低地平原。。它是什么颜色的。
我比较喜欢跟岳云鹏搭档的孙越岳云鹏是天秤座的	你有比较喜欢的相声演员吗。有啊郭德纲。我比较喜欢跟岳云鹏搭档的孙越他是天秤座的。
1q84是高桥凉介才对	1Q84的作者是谁。你不知道是村上春树啊。是高桥凉介才对。
电影皮娜你可以欣赏一下皮娜	德国的纪录片你喜欢看吗。只要是纪录片我都喜欢看。电影皮娜你可以欣赏一下。
嗯嗯感觉好像也就只有香港导演区丁平可以拍出南京的基督来	南京的基督这部电影据说很不错。我去了解一下。嗯嗯感觉好像也就只有香港导演区丁平可以拍出这样的电影来。
恋爱通告恋爱通告是最简单的情片了	喜欢爱情片吗推荐给你一部爱情电影吧。非常喜欢啊。恋爱通告这是最简简单单的愛情片了。
沈阳大学教学质量怎么样	大家怎么评价沈阳大学的。是填志愿用来兜底的大学。教学质量怎么样。
佩小姐的奇幻城堡得过奖吗	罗海岭演的佩小姐的奇幻城堡什么时候上映。目前暂无《佩小姐的奇幻城堡》上映消息，你可以问问小布其他的热播作品。。得过奖吗。
你觉得三体怎么样	三体 怎么样。三体是神作。你觉得怎么样。
不清楚颜丹晨	有好多个。颜丹晨知道不很漂亮的女星。不清楚她。
叫他说一句话	那你的爸爸妈妈。当然是程序猿呀。。叫他说一句话。
啊徐若瑄好漂亮	谁啊。徐若瑄啊。啊她好漂亮。
听你说完我也挺喜欢任鹏的	看来任鹏演技应该挺好的。他毕业院校是在中央戏剧学院还有一部代表作叫胜利大阅兵。听你说完我也挺喜欢他的。
谢谢推荐听控制听名字肯定还不错	是嘛我很喜欢这类的电影是哪部呀。电影名字是控制可以去看看票房4374万呢。谢谢推荐听名字肯定还不错。
好的有时间去看看孽欲狂潮	看啊有好看的么。孽欲狂潮。好的有时间去看看。
而且我想和你的主演很有气质很漂亮我超级喜欢你知道是谁吗	我喜欢看她演的我想和你好好的很好看。好的。而且这部影片的主演很有气质很漂亮我超级喜欢她你知道是谁吗。
女子旁的她	给他打电话。你要打给谁呢。女子旁的她。
老店就很不错你看过吗	古榕导演的电影你有喜欢的吗。喜欢啊。老店就很不错你看过吗。
啊啊啊我知道阿凡达	哪一期。前两年的阿凡达上映后的一个李光洙扮演阿凡达笑死了。啊啊啊我知道那个。
吉林明天的天气	吉林今天的天气。吉林今天的天气是霾转多云零下17度到零下9度微风小于3级。明天的天气。
琵琶的历史记录	琵琶有什么经典的曲目。《十面埋伏》。。它的历史记录。
然而页面他带着四个四百个毛毛	附近的川菜。好的你要的川菜来啦。然而页面他带着四个四百个毛毛。
我好久都没有易烊千玺的消息了	易烊千玺。千玺棒棒哒。我好久都没有他的消息了。
创造营2020已经做了多少期了	你知道创造营2020的播出时间吗。每周六、周日20:00，锁定《创造营2020》，想看就看，要看得敞亮。。已经做了多少期了。
对呀就是张国标呀张国标长得帅吧	哈哈你是开了头收不了尾哈我当初也是看完1就特别想看2。然后看1的时候就觉得那个张国标长得帅昨天看发现是武媚娘传奇里面的那个李治演员名字叫李治廷。对呀就是他呀长得帅吧。
我也很喜欢刘昊然是挺帅的	也是那叫什么名字。刘昊然他就是凭借该片入围第21届北京大学生电影节最佳新人奖。我也很喜欢他是挺帅的。
我不知道周轩	周轩是谁。可能是一个女子的名字。我不知道她。
他妈老子又不是开	我说去年。那你现在读哪。他妈老子又不是开。
给你推荐一部记录片叫做第十一个小时2007年8月17日上映的电影	喜欢看电影吗。喜欢尤其是纪录片。给你推荐一部记录片叫做第十一个小时2007年8月17日上映的。
岁月的童话这部电影值得一看你看过吗	有部关于小女孩的电影。我喜欢这种你说的什么电影。岁月的童话这部电影值得一看你看过吗。
哦我他妈谢谢你	说的好像很有道理。你的一句肯定小布真的很开心。哦我他妈谢谢你。
打电话给他	打电话给打。你要打给谁呢？。打电话给他。
他们闹起来	戏不要在。那你要我。他们闹起来。
哈哈吴珊卓我得了解了解	女主到是听上去很厉害电影我就不看了告诉我女主角叫什么呗。她叫吴珊卓巨蟹座的她真是个人才。哈哈这位美女我得了解了解。
这个周末有时间去看看琉璃庭院	17年时候很忙没怎么关注电影。推荐你看一下琉璃庭院这部电影很不错。这个周末有时间去看看。
看过了darknessintallinn确实不错	他的电影我挺喜欢的。darknessintallinn看过吗不错的电影。看过了这部确实不错。
道士下山主角	道士下山男主角还演过什么。《道士下山》的男主角由王宝强饰演，他还出演过《新喜剧之王》等作品，你肯定又上头追剧了。。主角。
刘松仁谁呀	你是不是收了刘松仁的钱，一直在说。抱歉，你命中了小布知识盲区。。他谁呀。
没看过脱轨时代我会看脱轨时代的	在唐山大地震里看过她。她演的电影脱轨时代你看过吗。没看过我会看的。
陈玉芳说	陈玉芳是傻子吗。疯子呢！。他说。
说来听听看	诶哟不错哦听起来是份好工作。对啊我知道了很多以前不认识的明星也发现了很多不错的电影。说来听听看。
一吻定情好看吗	你知道一吻定情不。这题小布会答，《一吻定情》是爱情片类型影视作品，讲述了少女原湘琴追求天才少年江直树所发生的校园爱情故事。主演是小布最喜欢的王大陆，你知道他吗？。好看吗。
我儿子也让他们带走了	我媳妇跟人跑了。不妥协不强求不讲究。我儿子也让他们带走了。
午夜梦回这部影片就是讲的这个	你觉得梦游的人可怕吗。可怕我睡觉还会说梦话。午夜梦回这部影片就是讲的这个。
不是他们去	是插住的宾馆。你想预订哪个城市呢。不是他们去。
我操王说	姓王的是不是我儿子。他是我儿子的。我操他说。
为什么天龙八部里谁的武功最高的武功是段誉	天龙八部里谁的武功最高。是段誉。为什么。
你看过舍不得大猪蹄子舍不得卫龙吗	我最近在追延禧攻略。哎前几天刚看完舍不得大猪蹄子舍不得卫龙。你看过吗。
短跑吗我对星座更感兴趣	热爱运动啊。考考你你知道刘翔在奥运会参加什么项目获得的金牌吗。短跑吗我对星座更感兴趣。
朝圣的导演是杰拉德巴雷特跟你一样祖籍都是爱尔兰的哦	朝圣。好的上映就去看呗。这部电影的导演是杰拉德巴雷特跟你一样祖籍都是爱尔兰的哦。
瞎说你都没去过绿江村	绿江村好不好。你也喜欢吗咱俩好有缘分啊我特别喜欢。瞎说你都没去过。
澳门是矩记饼家	我在澳门。澳门最好吃的是什么。是矩记饼家。
好的我这就去看无名演员	没看过啊是喜剧片吗。不是喜剧有部国外电影无名演员跟那个类型挺像的很不错看看吧。好的我这就去看。
王文彬是谁	算算  王文彬的运势。啥 没听 清。他是谁。
马云很有钱吗	马云是谁。做过中国首富也是有名的慈善家。他很有钱吗。
何美钿网友评论何美钿是内地演员啊我一直以为何美钿是香港人推荐你去了解一下何美钿	你知道这部电影的主演是谁吗你俩都是广州华南理工毕业的。不知道是谁呢。何美钿网友评论她是内地演员啊我一直以为她是香港人推荐你去了解一下。
我也想胡慧娟了	胡慧娟。我想胡慧娟了。我也想她了。
有一部臧金生主演的电影和张勇手搭档主演的你了解吗	臧金生啊非常优秀的。是吗那我等下去关注下。有一部他主演的电影和张勇手搭档主演的你了解吗。
也是他不规矩的感觉	换名字吗。小度还不会系统改名哦。也是他不规矩的感觉。
不行我要看他的	自己家吗。你在哪儿我的家就在哪儿。不行我要看他的。
爵迹女主角还演过什么	吴亦凡是演爵迹里面的哪个人。银尘是吴亦凡演的哦，这个角色是小布整部剧的心中最佳，你有没有这种感觉？。女主角还演过什么。
不知道谢天华说来听听	还是不认识哈哈。谢天华还有一部非常好的代表作你知道是什么吗。不知道说来听听。
其实就是想给你推荐一部爱情电影叫凝望上帝你去看看吧	你相信上帝吗。我不信我就信自己。其实就是想给你推荐一部爱情电影叫凝望上帝你去看看吧。
我要怎么领取宠物	怎么领宠物。点击领取。我要怎么领取。
和你一起吃牛肉火锅啊	牛肉火锅好好吃的。好吃你就多吃点吧。和你一起吃啊。
死亡真相应该不错我去了解一下	当然了我没事经常看。有一部叫死亡真相的电影挺好看你看过吗。应该不错我去了解一下。
胡慧中这么厉害哦	有时间我了解一下胡慧中吧。好的她可是一代打女哦。这么厉害哦。
宋丹丹是处女座的主要成就是第6届中国电视飞天奖最佳女配角	这部影片是宋丹丹的代表作她可是我的偶像哦。我也很喜欢她。她是处女座的主要成就是第6届中国电视飞天奖最佳女配角。
春节想去泰国	去哪玩呢。泰国呀。春节想去。
谢谢你的建议我会避开看同囚的	就ab演的电影吧。同囚这部电影也是口碑很差的拍的还不错但是故事不好。谢谢你的建议我会避开看这部电影的。
告诉你叫黑泽明1948合作三船敏郎最强电影搭档诞生	三船敏郎的搭档知道是谁吗。不知道。告诉你叫黑泽明1948合作三船敏郎最强电影搭档诞生。
太阳有多大	太阳怎样。太阳是太阳系的中心天体，占有太阳系总体质量的99.86%。太阳系中的八大行星、小行星、流星、彗星、外海王星天体以及星际尘埃等，都围绕着太阳公转，而太阳则围绕着银河系的中心公转。直径大约是地球直径的109倍；体积大约是地球的130万倍；其质量大约是地球的330000倍。。它有多大。
你吃过鲱鱼罐头	鲱鱼罐头什么味道。味道着实不错。你吃过。
我回去了解下肖恩康纳利	很少去关注。您可以去了解一下肖恩康纳利生于英国苏格兰爱丁堡他因为铁面无私这部电影而获得第60届奥斯卡金像奖最佳男配角奖。我回去了解下。
怎么搭配色彩	色彩搭配。更多服装颜色搭配的技巧和图片。怎么搭配色彩。
恐怖不	哪部美剧好看。行尸走肉的第一季特别特别特别好看。恐怖不。
那等我吃饱了了解了解杨史云梅耶	叫什么名字他很老么。是啊他叫杨史云梅耶还是处女座的呢。那等我吃饱了了解了解。
她说很适合你	唉我穿哪个衣服好看。很不错，很适合你。她说很适合你。
豆汁很好吃啊有段时间我天天煮来吃你加点蜂蜜试试	有烤鸭豌豆黄艾窝窝豆汁呀。豆汁听说很难吃。很好吃啊有段时间我天天煮来吃你加点蜂蜜试试。
你让我看什么我让他看小布说话	我真的太生气了。别生气气出病来无人替。你让我看什么我让他看小布说话。
没看过新唐山大兄应该不错啊	喜欢有什么推荐吗。有一部电影挺好看的新唐山大兄看过吗。没看过应该不错啊。
谢谢改天有时间我就去欣赏一下姐姐走了金彰来	是什么电影啊。电影名字叫做姐姐走了金彰来导演的。谢谢改天有时间我就去欣赏一下。
我去看看妙趣孖宝应该不错	喜欢有好看的吗。我给你推荐一部比较搞笑的名字叫妙趣孖宝。我去看看应该不错。
别管他别管他	不管什么这是我姐说的。就是你姐姐啊。别管他别管他。
薛之谦的很多歌都好听	我不喜欢薛之谦。诶你知道薛之谦哪首歌最好听吗。他的很多歌都好听。
说两句英语听听	你会说英语吗。小菜一碟啊。说两句听听。
没看过幸福在2010呀有时间就看看幸福在2010	嗯在唐人街探案中有精彩表演。也演过幸福在2010。没看过呀有时间就看看。
那当然了叶璇有个代表作叫新孟丽君传奇很不错的而且戏王之王是叶璇主演的呢	是呀叶璇还是第三届新人最佳女主角奖29届最佳女配奖。是挺喜欢她的奖也挺多的人也长得漂亮。那当然了她有个代表作叫新孟丽君传奇很不错的而且戏王之王是她主演的呢。
好的我提前跟你说一下岩井俊二主演的电影已经上映了哦	岩井俊二也很不错你可以试着关注一下他。这事明天再说好吗。好的我提前跟你说一下他主演的电影已经上映了哦。
可能是不对第二次呼吸的胃口吧	不了解啊。看了他导演的第二次呼吸有人说乏味无趣我觉得ok啊。可能是不对他们的胃口吧。
射手座是一个爱和平爱自由的代表性星座啊	你们射手都特别的爱自由。射手座怎么了。一个爱和平爱自由的代表性星座啊。
他是刘海红	我要打电话。你要打给谁呢？。他是刘海红。
梦三国也没玩过	好吧我没玩过。梦三国呢。也没玩过。
哦我对申河均有点印象	这么巧主演是谁啊。申河均他在我要复仇中的表现令人印象深刻呢。哦我对他有点印象。
是啊车晓现在演戏越来越好了	电影车晓演的。大概看了下网友觉得还不错。是啊她现在演戏越来越好了。
那我给你推荐一部电影你可以带着你女朋友一起去名字叫敦煌不了情	你相信爱情吗。相信啊我对爱情充满憧憬。那我给你推荐一部电影你可以带着你女朋友一起去名字叫敦煌不了情。
囚车驶向圣地的导演是拉杜米赫罗你知道拉杜米赫罗吗	囚车驶向圣地。那我也去看看。这部电影的导演是拉杜米赫罗你知道他吗。
还是看看蝴蝶君的好	二十年前我才几岁不知道哪部。名字叫蝴蝶君这是一部充满意淫的荒诞剧你没看过的话就别看了。还是看看的好。
喜宴谁的	中午吃什么。我出去吃喜宴。谁的。
阿凡达真不知道	一点也不夸张呢。真的假的那你知道萨姆沃辛顿主演的阿凡达吗。这个真不知道。
打给她老公	打电话。你要打给谁呢？。打给她老公。
我要去找李长健	我爱李长健。当初是你要跳海跳海就跳海现在又要爬上来把我拖下海。我要去找他。
什么非常好看的电影啊	可以啊那要等我回家再说了。他有部动画电影非常好看我已经看过很多遍了。什么电影啊。
二胡介绍	芦笙介绍。芦笙是西南地区苗、瑶、侗等民族的乐器。 发源于中原，前身为汉族的竽，后传入少数民族地区。芦笙分为轻音芦笙和重音芦笙，重音芦笙的曲调深沉而洪亮，轻音芦笙则轻盈而高亢，芦笙曲调大体分为《祭祀》、《抒情》和《叙事》等三大部分。。二胡呢。
这是他出啊	怎么截图。三指下滑快速截屏一切尽在掌握中。这是他出啊。
现在有磊磊磊是我前男友吗	小波他是谁。前男友。现在有磊磊他是我前男友吗。
你怎么知道喜欢的男孩是不是真爱呢	我有一个喜欢的男孩。世上朋友千千万，遇到真爱去表白。。你怎么知道他是不是真爱呢。
二手雄狮的主演是罗伯特杜瓦尔你了解吗	推荐一部电影叫二手雄狮演的很好有时间看一下。timmccanlies导演的作品都不喜欢。这部电影的主演是罗伯特杜瓦尔你了解吗。
间接夸了孙艺珍一把爱有天意里真美的让人心碎	孙艺珍跟人的感觉好清纯。我们a型血的独有气质。间接夸了自己一把爱有天意里真美的让人心碎。
朱俊是不是找小妹了	你认识朱俊吗。熟啊。他是不是找小妹了。
成都真是个好地方	你是哪里人啊。成都的。真是个好地方。
你说的是哪个女主演	哈哈好我这就去看看。这部电影里的女主演也不错啊很有味道还曾经提名2013年第13届华语电影传媒大奖最佳女配角呢。你说的是哪个女主演。
了解一下王者吧	我是最强王者。王者不配有cp。了解一下吧。
知道我很喜欢李维嘉	看过啊怎么了。那你一定知道李维嘉了。知道我很喜欢他。
杀破狼2的导演谁啊杀破狼2的导演我还真不知道呢	是的我看过了。那你知道杀破狼2的导演是谁吗澳门的哦。谁啊这个我还真不知道呢。
喜欢张碧晨的嗓子	张碧晨嗓音独特。我特别喜欢张碧晨。喜欢她的嗓子。
那你管马云叫什么	我哪里知道谁支付可能是马云吧。全国人民都知道啊，好多人都管他叫“爸爸”呢。那你管他叫什么。
扮狗脸的日子我好像看过讲的是大叔和小萝莉的友谊sam演的比较好	因为英国的人皮肤是白色的头发是金色的啊漂亮。哈哈我最近看了一部英国的电影叫扮狗脸的日子。这部电影我好像看过讲的是大叔和小萝莉的友谊sam演的比较好。
跟他说的	我非常的喜欢。那你就去告白。跟他说的。
他都不读了	真的吗这么爱我。爱你想把全世界给你。他都不读了。
叫小冰出来吧	小冰呢。小冰一直在后台等着闪亮登场。。叫他出来吧。
待我观察下神笔马良影评	偶尔去孩子也喜欢看电影。一部大人孩子都爱看的电影叫神笔马良很火的。待我观察下影评。
古筝怎么制作	制作古筝需要什么工艺。古筝的制作：筝由面板，底板、边板、筝头、筝尾、岳山、码子、琴钉、出音孔和筝弦等部位组成。筝的优劣取诀于各部分材料质地及制作工艺的高低。筝的共鸣体由面板、底板和两个筝边组成。在共鸣体内有音桥，呈拱形，它除了共鸣效果的需要外，还起着支撑的作用。共鸣体的质量和结构对筝的音响影响很大。。它怎么制作。
我就知道说的是赵学而	你说的是谁啊不知道你和我说的是不是一个人。名字叫赵学而。我就知道说的是他。
生命因你动听里面有一位主演长得特别帅肌肉型男	生命因你动听你看过吗。听说过特别喜欢。这部剧里面有一位主演长得特别帅肌肉型男。
那我不知道能不能看懂爱恨	好呀。爱恨我没看懂。那我不知道能不能看懂。
里克高莫兹我知道啊还不错啦你知道还有谁参演了吗	好的我会去看黑客帝国动画版的。这个电影的主演是里克高莫兹我挺喜欢这个演员的。这个演员我知道啊还不错啦你知道还有谁参演了吗。
但是王新赫有男朋友	我喜欢王新赫啊。看看那拉婆娘来冒酸皮皮了没有。但是她有男朋友。
李汶翰是我老公	对啊李汶翰照片。所以呢。他是我老公。
有部叫蓝白红三部曲之白你看一下蓝白红三部曲之白描述的就是女性视角	总要在伤害过后才更明白爱。哎是啊。有部叫蓝白红三部曲之白你看一下这个电影描述的就是女性视角。
推荐你一部危情密码可以去关注下	你有关注的电影吗。有啊有什么推荐。推荐你一部危情密码可以去关注下。
吴世勋喜欢的人是谁	你认识我吴世勋吗。爱啊啊啊啊忙内。他喜欢的人是谁。
古琴就是古老的一种乐器	你知道古琴吗。什么叫 古琴。就是古老的一种乐器。
吴世勋是我的呢亲	吴世勋。我觉得吴世勋从头到脚都十分极品。他是我的呢亲。
武庄村是我老家	你知道武庄村吗。不知道。这是我老家。
没看过人间喜剧	看过剧情还不错。嗯嗯还有一部电影叫人间喜剧剧情也不错哟。没看过。
嗯嗯那我不看黑豹了	哪部啊。电影叫黑豹时光网短评说实话实在欣赏不能的电影。嗯嗯那我不看了。
他老婆很好	不你别听他的他老婆很好。抱歉，我还是没听懂，可能需要你说慢一点。他老婆很好。
这个男人来自地球主演是谁呀	好呀乐意之至。这个男人来自地球这部电影大众评价很不错。主演是谁呀。
什么freddydouglas主演的电影说来听听	好啊那我就去看一下。你看过freddydouglas主演的电影吗。什么电影说来听听。
这个我就猜不到呀你就别卖关子了快说	是什么黑色动画电影啊。你猜猜看是欧美的但是这部动画是与迪斯尼奥斯卡无关的。这个我就猜不到哎呀你就别卖关子了快说。
是吗有时间我去了解一下张书豪	不太了解台湾的男演员可以推荐一个吗。给你推荐一个张书豪还获得过第42届金钟奖迷你剧集男主角奖。是吗有时间我去了解一下。
不想理我男朋友	我男朋友惹我生气了。拍拍怎么了吵架了。不想理他。
心花路放上映了吗	叫什么名字。心花路放。这部电影上映了吗。
对对是冯远征	时间长了忘记叫什么了。男主叫冯远征。对对是他。
我知道蔡升晏是属蛇的跟我同岁	我的偶像周董啊人生赢家。那你听说过蔡升晏吗毕业于辅仁大学社会学系好萌的。我知道他是属蛇的跟我同岁。
不过诡婴吉咪网络评分不是太好有点低个人感觉诡婴吉咪还不错的一部恐怖片	徐子珊主演的诡婴吉咪是吧我看过诡婴吉咪很带劲。嗯我也很喜欢看。不过网络评分不是太好有点低个人感觉还不错的一部恐怖片。
孩儿孩儿妈	打电话给孩儿他妈。你要打给谁呢？。孩儿他妈。
陈雅伦就是和我一样都是b型血的林杰妮一个水瓶座的明星	你知道陈雅伦和谁主演的天下太平吧。谁呀。他就是和我一样都是b型血的林杰妮一个水瓶座的明星。
王全安王全安是北京电影学院毕业的和你一个母校呢	主演是吴超那你知道月蚀的导演是谁吗。不知道是谁。王全安他是北京电影学院毕业的和你一个母校呢。
杰米福克斯长得也很黑但是杰米福克斯演技很棒的	像杜兰特长得苦瓜脸你知道说的是谁吗。不知道说的是谁呀是不是长得不帅。杰米福克斯长得也很黑但是演技很棒的。
可我想小艾同学呀	小艾同学。提起别人小布吃醋啦。可我想他呀。
你吃凤梨吗	吃凤梨吗。甜甜的。你吃吗。
谢尚龙是先上楼	谢尚龙让你闭嘴。别说话那么凶。他是先上楼。
冬天的访客评论的导演是艾伦里克曼曾在威尼斯电影节上获过奖呢	冬天的访客评论里说看艾玛的表演。那要注意一下。这部剧的导演是艾伦里克曼曾在威尼斯电影节上获过奖呢。
嗯谢谢你的推荐我对汤镇业没有抵抗力	我比较喜欢大陆明星。可以去多了解下香港地区的明星比如汤镇业很霸气的。嗯谢谢你的推荐我对这种男的没有抵抗力。
知道啊中国主席老婆彭丽媛我们老乡	知道啊我们老家的大明星呢。你知道中国主席是谁吗。知道啊他老婆彭丽媛我们老乡。
我也是通过电影才了解火烈鸟的	你见过火烈鸟吗。真的没见过电视见过。我也是通过电影才了解的。
kobochan的主角谁啊	看过kobochan啦确实很喜欢。这部电影是1992年10月19日上映的我很喜欢这部影片的主角。谁啊。
哪一位水瓶座明星啊有这么巧的事情啊	好的我以后会关注他的相关作品的。有位水瓶座明星和他是同一天出生呢。哪一位明星啊有这么巧的事情啊。
电视剧危城什么时候播出	刘青云出演的危城是什么时候。小布在手，资讯全有。《危城》于2016年08月12日正式上映。。电视剧什么时候播出。
火线追凶之绝命狙击好看吗	我对女明星不是很感兴趣男明星还可以。呵呵给你推荐一部电影火线追凶之绝命狙击。好看吗。
因为siri比你聪明	你知道Siri吗。怎么突然提起她了，我吃醋啦。。因为他比你聪明。
爱他的朋友多好这个分析朋友	这朋友多好。你好啊朋友。爱他的朋友多好这个分析朋友。
媳妇儿说操你妈傻逼	给媳妇儿发送短信。你要发送什么内容？。他说操你妈傻逼。
嗯呢我在看chrisgethardcareersuicide	抑郁症真的挺可怕的。对很容易自杀。嗯呢我在看chrisgethardcareersuicide。
他是傻逼不	去吧去吧。感觉这要打持久战啊。他是傻逼不。
不知道非常优秀的配音演员是金牛座的吗	我好像没有特别喜欢的明星。有一个非常优秀的配音演员你知道吗。不知道他是金牛座的吗。
是的克日什托夫基耶斯洛夫斯基是一位非常受关注的导演	对呀你刚刚知道克日什托夫基耶斯洛夫斯基吗。我还听说他是波兰洛兹电影学校毕业的。是的是一位非常受关注的导演。
在哪看的电影我去找找	噢京剧电影很少见吧。对呀叫曹操与杨修好精彩哦。在哪看的我去找找。
知道了周显欣演的确实不错	你说谁的替身啊。周显欣他的替身让我也傻傻分不清。知道了她演的确实不错。
你可以来浦北这里玩几天呀要不要你的钱是不是你你告诉李澜你说去广东了去广东了吧	发短信给李澜。你要发送什么内容？。你可以来浦北这里玩几天呀要不要你的钱是不是你你告诉他你说去广东了去广东了吧。
但是我打一个人不赢	我想打一个人。想她就去找她。但是我打他不赢。
杨庆还是个导演杨庆导的一部喜剧电影特别好看	是杨庆是重庆人。哦是重庆人啊。他还是个导演他导的一部喜剧电影特别好看。
那你知道志气是谁的代表作吗志气可是一位o型血的明星哦	电影的名字是志气是一部励志的电影。这部电影看过了还不错。那你知道这部电影是谁的代表作吗她可是一位o型血的明星哦。
十面埋伏信息	塞上曲信息。《塞上曲》是一首传统琵琶文曲，乐曲描写了王昭君对故国的思念，表达了哀怨悲切之情。。十面埋伏呢。
嗯嗯李华月主演的一部叫霹雳女杀手的电影很不错呢值得观看	李华月也是哦也很有实力的。嗯她是一位很有实力的女明星。嗯嗯她主演的一部叫霹雳女杀手的电影很不错呢值得观看。
他皇之	包罗万象。你真棒回答正确啦第6关相貌堂堂。他皇之。
那你是段奕宏	不要我只要段奕宏的小心心。你也太不贪心了，小孩子才做选择，小布要亲亲加心心。。那你是他。
他说我胖	我好看吗。今天少吃一块肉，明天维密你走秀。明天少喝一口汤，后天维密你开场。。他说我胖。
但女友和我都喜欢那个女孩	女友被兄弟抢了。这样的朋友铁定不是真正的哥们。但他和我都喜欢那个女孩。
阿托姆伊戈扬网上评论阿托姆伊戈扬电影拍的是人而不是故事	这部电影的导演和你一样祖籍是埃及开罗的。是吗是哪位啊。阿托姆伊戈扬网上评论他电影拍的是人而不是故事。
对啊陈学冬才65kg	陈学冬啊。哈哈哈他口碑好差还好瘦。对啊才65kg。
湄洲岛也太远了	湄洲岛太远不想去。可以去深圳湾。那里也太远了。
我爱妈妈	妈妈。你要发送什么内容？。我爱他。
电影叫陈友长得也很帅	看过他很多电影很幽默他为香港电影增加了光彩。是谁这么优秀。他叫陈友长得也很帅。
因为露脸好看呀	怎么不露脸呀。为什么要露脸。因为好看呀。
赵雅芝的白娘子经典啊	你觉得赵雅芝怎么样。从小就爱赵雅芝姐姐。她的白娘子经典啊。
他的名字叫李逸晨	手机电话呀。告诉我要查询的名字吧？。他的名字叫李逸晨。
他吃粑粑	我吃粑粑。顺其自然想拉就拉。他吃粑粑。
微软ceo是哪国人	微软ceo是谁。当然是萨蒂亚纳德拉啦。是哪国人。
满城尽带黄金甲是5年前上映的票房有291亿呢感觉满城尽带黄金甲还好的啊	满城尽带黄金甲评分也很低但我觉得满城尽带黄金甲真的很不错呢。每个人爱好不一样避讳。这个电影是5年前上映的票房有291亿呢感觉还好的啊。
你为啥觉得潘霜霜漂亮	潘霜霜 是哪个。一个女的台州的 最近和林峰传出了一些亲密的照片 算红了。你为啥觉得他漂亮。
不知道唐嫣谁啊	好吧也是哈。你知道没有言语的生活是唐嫣跟谁的代表作吗。不知道谁啊。
不知道你给我查一下爱情麻辣烫之情定终身的导演的资料吧	好的我一定会看爱情麻辣烫之情定终身的。你知道这部电影的导演是谁吗他是白羊座的。不知道你给我查一下他的资料吧。
哈哈白羊座的女性估计爱情上比较主动说不定梁咏琪老公也是梁咏琪主动追到的手呢	我也觉得谁没有年轻过呢梁咏琪就是现在年纪大了。她嫁人后作品逐渐减少了我们只能看看她年轻时的作品了像口碑不错的光辉岁月是2000年上映的。哈哈白羊座的女性估计爱情上比较主动说不定她老公也是她主动追到的手呢。
你可知道欧洲攻略	"你看过欧洲攻略吗。小布在手，资讯全有。《欧洲攻略》讲述了特工天团的成员林在风、王朝英和洛奇临危受命远赴欧洲，追寻全球监控系统""上帝之手""的下落的故事。。你可知道。"
你说凯恩欸能不能拿下今年的神射手呀	啊话说刚查了下射手榜第一是凯恩欸6球。谁。你说他能不能拿下今年的神射手呀。
害怕午夜整容室赖晶晶主演的电影叫午夜整容室赖晶晶主演的电影怕我胆子可没那么小	那简直太好了我最爱看惊悚片了。你可别害怕电影叫午夜整容室赖晶晶主演的。害怕我胆子可没那么小。
你出来工作多久了	名字叫八星抱喜。嗯嗯我这就去看。你出来工作多久了。
小河是你永远的好朋友吗	你会认识小河吗。好像.听过但是不认识。他是你永远的好朋友吗。
唐三还有个儿子	如何评价唐三。唐三只有女儿。还有个儿子。
你们两个别她都给你	他们都不会。那你会不会有很难过的时候。你们两个别她都给你。
打电话给他	小布小布。被你喊过的名字，叫泡芙，因为都很甜。说吧什么事？。打电话给他。
我的妹妹说	我的妹妹。妹妹们小时候是小恶魔，长大了就是最贴心的小天使。。他说。
金星拥有什么资源	小金星。小金星系为超能/岩石，高30CM，重量12G，爱好是数星星，性格温柔和善。。它拥有什么资源。
我想我男朋友了	我男朋友不理我了。不要秀男友了你考虑考虑我！。我想他了。
就是老坛酸菜味儿	方便面。老坛酸菜的吗。就是 这个 味儿。
电影叫末日来电网上评论说末日来电题材很好就是剧情薄弱了演员就是偶像派就好	正好这里有一部她已经上映的电影而且是她主演的你一定会喜欢的。要不你说一下吧。这部电影叫末日来电网上评论说题材很好就是剧情薄弱了演员就是偶像派就好。
洪辰还有一部代表作叫妄想症我看了妄想症之后感觉还不错哦	洪辰这位明星可以关注一下他也是天秤座的。好啊我这就去关注下。洪辰还有一部代表作叫妄想症我看了之后感觉还不错哦。
我觉得小艾比你好多了	你认识小艾吗。为什么突然问这个你想要抛弃我吗。我觉得他比你好多了。
没有时间看折翼天使啊	我和喜欢外国电影你说的是哪一部电影。电影名字是折翼天使挺好看的有时间可以去看看。没有时间看啊。
天王星直径是多少	地球直径是多少。地球的直径为12756 km。。那天王星呢。
海龟露营好玩吗	你今天出去玩了吗。是的去海岛露营了。好玩吗。
他们回答不可以	不问他。问了还没回答。他们回答不可以。
国内的感觉都很雷同	最近看了太多喜剧片都感觉剧情一样了。你是看国内还是国外的。国内的感觉都很雷同。
你知道中餐第二季的导师吗	中餐厅第二季已经做了多少期了。不数不知道，《中餐厅第二季》已带给我们12期的幸福时光。。你知道的导师吗。
前几天我还看过一部动作片很好看呢	他的作品西风烈挺不错的有时间记得看看。恩我记住啦我会去看的。前几天我还看过一部动作片很好看呢。
女朋友无理取闹怎么办	该怎么哄女朋友呢。死皮赖脸的向女朋友道歉总之你不能不管女朋友女友很好哄的啦。她无理取闹怎么办。
威廉莫纳汉威廉莫纳汉身高182cm	遗落战境的编剧你知道是谁吗祖籍是美国马萨诸塞州波士顿的。不知道。威廉莫纳汉身高182cm。
可不是吗经济学忒难了那是	复习微观经济呢我。经济学难啊。可不是吗忒难了那是。
我想他了	陪我聊天。小布在这里陪着你哦，想聊点什么呢？。我想他了。
沈腾最新上映的电影是什么	你知道沈腾吗。连续四年登上春晚舞台把郝建演得深入人心。他最新上映的电影是什么。
乘风破浪演员有	邓超是不是演过乘风破浪。邓超在戏里扮演徐太浪，表现十分亮眼，你觉得呢？。演员有。
什么评分为6分的喜剧电影啊	谢谢你的推荐。最近看了一部评分为6分的喜剧电影。什么电影啊。
重庆明天天气	重庆的气温。重庆今天最高温度11度最低温度7度温度适宜和好朋友一起出去玩吧。明天天气。
看了一部惊世狂花感觉非常不错	你是不是感觉我有怀旧情绪。谁知道呢所以说最近又看什么老外国电影啦。看了一部惊世狂花感觉非常不错。
你送我冰皮月饼呗	我想吃冰皮月饼。想就行动起来呗冰皮月饼简直太精致了像雕花简直舍不得吃。你送我呗。
我已经够了解柏寒了	我不知道你就好人做到底告诉我吧。她就是柏寒是中国江苏扬州人了解一下吧。我已经够了解她了。
有圣索菲亚教堂图片吗	土耳其有什么好玩的。去土耳其玩不去圣索菲亚教堂怎么行推荐你啊。有图片吗。
我可以点刘若英的歌吗	刘若英的后来。喜欢刘若英的嗓音。我可以点她的歌吗。
我们去看电影荣获了2008年东京国际电影节的特别奖	我俩去看电影去吧很久没聚聚了。可以啊是该去看看电影看些什么电影呢。我们去看荣获了2008年东京国际电影节的特别奖。
我也是看supportthegirls导演介绍知道的是今年8月份上映的电影	supportthegirls一部喜剧片。还真没有印象好像没有在国内上映吧你在哪看见的。我也是看导演介绍知道的是今年8月份上映的。
我没吃过海星	海星。哈哈据说海星能吃呢。我没吃过。
朱一龙好看不	我喜欢朱一龙。这个夏天有沈教授真好。好看不。
嗯嗯血滴子的成功也得多亏了血滴子背后的导演刘伟强啊	有没有看过血滴子。看过感觉还不错。嗯嗯这部电影的成功也得多亏了它背后的导演刘伟强啊。
有什么办法吗	怎么瘦呢。木有瘦过。有什么办法吗。
我忘不了他怎么办	我还想他怎么办。想他一次，星星就多了一颗的样子。我忘不了他怎么办。
西安城墙有什么历史	西安景点推荐。觉得西安有个地方必须去看看就是西安城墙。那里有什么历史。
嗯还可以看过蜘蛛侠2	还可以啊挺激情的。蜘蛛侠2一定看过吧是不是挺刺激的。嗯还可以看过。
好多遍风的第一声呼吸的导演弗兰科皮亚维奥利可是一个很有才华的人	有一部电影看了好多遍风的第一声呼吸你可以看看。好的。这部电影的导演弗兰科皮亚维奥利可是一个很有才华的人。
我弟弟说你丑	这是我弟说的。你弟弟又怎么了啊？。他说你丑。
你觉得刘昊然帅吗	你知道刘昊然吗。一脸萌萌哒。你觉得他帅吗。
泰勒洛特纳是离不开摩托车的好莱坞明星	很多人喜欢泰勒洛特纳他只要站出来不用演靠样子就很厉害了。我知道也很喜欢。他是离不开摩托车的好莱坞明星。
哦哦我不认识马修古迪哦	谁啊。马修古迪英国的。哦哦我不认识哦。
我他妈要计时	打开计时器。设置什么时间呢？。我他妈要计时。
好啊你说的腊肠狗导演叫什么	我有时间可以去看一下腊肠狗。你要不要了解这部电影的导演啊他的祖籍是美国新泽西newark的。好啊你说的这位导演叫什么。
没有啊那是谁拿了中国电视金鹰奖	哪一届中国电视金鹰奖。14届啊。没有啊那是谁拿了金鹰奖。
长的这几天没跟他讲过你要我辞了	欢迎欢迎。谢谢吗欢迎去玩。长的这几天没跟他讲过你要我辞了。
跟女生聊天她说	跟女生。不是标准女汉子。跟女生聊天她说。
微信号给我我加他	那你需不需要男朋友。没有呀我在静静的等待缘分的到来。微信号给我我加他。
他是傻逼	我说一句你说一句。嗯句句发自肺腑。他是傻逼。
上海后天的天气呢	上海。上海明天的天气是小雨转阴7度到10度北风3级。后天呢。
对他想弄你	他想弄你。抱歉，我还是没理解，请你不要生气。对他想弄你。
想小布你可以让我见到他吗	听说过没见过。那么想见吗。想小布你可以让我见到他吗。
你和小爱同学是好朋友吗	你知道小爱同学是谁吗。进了我的门，就是我的人，说好一辈子，不许提别人。。你和他是好朋友吗。
嗯现在注重跟孩子沟通特别重要	难怪上周很少看到你我看了这部剧的宣传的片花也打算带我女儿看。虽然说是因为演主角的文淇小小年纪演技好但是那种压在心里的沉重感还是不能磨灭。嗯现在注重跟孩子沟通特别重要。
盲探还是郎月婷的代表作郎月婷可是我女神呢	他演了部电影叫盲探你应该听过吧。知道了原来是他呀。这部电影还是郎月婷的代表作她可是我女神呢。
加勒比海盗好像又出了新片	看过加勒比海盗啊好像加勒比海盗有几个部分呢。是啊前几部都很好看。好像又出了新片。
你怎么老是说大明星好自恋啊	你最喜欢的明星是谁。我就是大明星呀。你怎么老是说这句话好自恋啊。
还是一部老电影了啊我还真没看过呢	没有看过我都不认识她。叫抢救老爸2012年9月28日上映的。还是一部老电影了啊我还真没看过呢。
叫向阳不用回来	发短信给向阳。你要发送什么内容。叫他不用回来。
扬琴有什么代表作	扬琴长什么样。扬琴，又称洋琴、打琴、铜丝琴、扇面琴、蝙蝠琴、蝴蝶琴，属于击弦乐器。扬琴是中国民族乐队中必不可少的乐器。扬琴与钢琴同宗，音色具有鲜明的特点。慢奏时，音色如同叮咚的山泉，快奏时，音色又如潺潺流水。在民间器乐合奏和民族乐队中经常充当“钢琴伴奏”的角色，是一种不可缺少的主要乐器。。有什么代表作。
哈哈好臭啊	你有脚臭吗。闻你的脚味道。哈哈好臭啊。
多多益善啊顺便把资源发来	是啊很多都只能上网找资源看我很喜欢香港电影的。我也很喜欢要不要给你安利一部。多多益善啊顺便把资源发来。
朴宝剑是韩国大势男	朴宝剑。朴宝剑是谁。韩国大势男。
我这就去关注看一看赖声川导演的	我和我和他和他听名字应该很好看。对是赖声川导演的你可以了解一下呢。我这就去关注看一看。
昨天我看了一部由赵宝桦执导的母亲的肖像	你喜欢看家庭伦理剧吗。不怎么喜欢很少看。昨天我看了一部由赵宝桦执导的母亲的肖像。
地域的电视剧呢	有什么好看的电视剧吗。说真的内地电视剧我还真不怎么看。外地的呢。
可以的我要去看看危险人物	很厉害了有什么主演的作品吗。5年前上映的危险人物就是他和余文乐主演的呢。可以的我要去看看。
殷美玲是我的女朋友	殷美玲是谁。美女哟。她是我的女朋友。
给他这个	打开星座之家我的运势怎么样。请告诉小布你的星座是哪个。给他这个。
超凡战队男主角还演过什么作品	电视剧超凡战队主演有哪些。为它疯，为它狂，为它哐哐撞大墙。追《超凡战队》的我们都是上头姐妹。。男主角还演过什么作品。
黄伟明导演的一部电影是什么啊	好的我知道黄伟明他跟我一样是天蝎座的呢。我前段时间还看了他导演的一部电影很好看。是什么啊。
清水湾的孩子是一部不可错过的五星电影导演导得真好	电影名字叫清水湾的孩子电影演出了法国人的浪漫值得一看。我最喜欢看这种类型的电影了找机会看看。这是一部不可错过的五星电影导演导得真好。
好啊反正好剧不嫌多的	是啊我真的没看过啊。20年前上映的电影还有一部非常不错的这两部一起推荐给你吧。好啊反正好剧不嫌多的。
我的爸爸是谁	我是你爸爸。我的爸爸是伟大的人工智能工程师哦。他是谁。
陈意涵我不太清楚	那我找时间也看看。陈意涵毕业于台湾景文科技大学资讯管理系。这个我不太清楚。
风火轮2018年上映的电影	这部电影是美国的我还可以在推荐一部美国的电影给你。好的啊什么电影啊。风火轮2018年上映的。
我最喜欢麦曦茵了	导演越来越多你喜欢的导演是谁。导演还真的没接触过呢。我最喜欢麦曦茵了。
怎样骂金城武才好	金城武是你男友吗。追星真好，还可以做梦。但如果你了解过金城武的作品《十面埋伏》就知道，金城武不属于任何一个人，他为舞台而生。。怎样骂他才好。
你也玩崩坏3	我喜欢崩坏3。我也是看的崩了。你也玩。
哇有时间去关注一下屠魔战士	什么电影啊。这部电影由米兰达奥图主演名字叫屠魔战士。哇有时间去关注一下。
哇我最喜欢的就是歌舞类型的电影了	是吗遗传学歌剧是什么类型的电影啊。歌舞类型的感觉还可以的样子。哇我最喜欢的就是歌舞类型的了。
钟汉良属虎的明星属相到是很厉害	有名的太多了吧。有名的是很多但是这位明星比他们厉害多了他叫钟汉良属虎的。属相到是很厉害。
我操他刚刚把你的话录进去了	小布小布。你的小宝贝正向你奔来。我操他刚刚把你的话录进去了。
没问题一定会去看看佐伊索尔达娜的	阿凡达听名字很有意思呢阿凡达应该很好看吧。没错这部电影的主演叫佐伊索尔达娜你绝对会喜欢的哦。没问题一定会去看看的。
我还知道徐冬梅是摩羯座的	好像看过。你知道徐冬梅吗北京戏曲学院毕业的还挺不错的。我还知道她是摩羯座的。
她有男朋友	可是我不敢。再加点油也许就成了呢。她有男朋友。
太阳是什么颜色的	太阳介绍。太阳是太阳系的中心天体，占有太阳系总体质量的99.86%。太阳系中的八大行星、小行星、流星、彗星、外海王星天体以及星际尘埃等，都围绕着太阳公转，而太阳则围绕着银河系的中心公转。直径大约是地球直径的109倍；体积大约是地球的130万倍；其质量大约是地球的330000倍。。它是什么颜色的。
太阳的半径是多少	为什么太阳从东方升起。太阳东升西落是由于地球的自转。。它的半径是多少。
我没谈过恋爱呢	你谈过恋爱吗。肯定比你少啦。我没谈过呢。
约翰赫特约翰赫特应该再多演些主角的否则就太浪费演技了	里边的主演非常不错是一个老牌影帝。谁啊。约翰赫特他应该再多演些主角的否则就太浪费演技了。
少林足球女主角还演过什么电影	周星驰是演少林足球里面的哪个人。周星驰在剧中饰演星，剧本身已经足够好看，比剧情更好看的是周星驰的演技。。女主角还演过什么电影。
我才不玩第五人格呢	不玩第五人格。这么好玩的游戏咋个不玩呢。我才不玩呢。
别惹我导演还是米歇尔菲佛的代表作我很喜欢米歇尔菲佛的哦	别惹我导演是吕克贝松挺搞笑的一部电影推荐给你看。好我去看看。这部影片还是米歇尔菲佛的代表作我很喜欢她的哦。
你看过印度的另一部获得奥斯卡金像奖提名的电影吗	我的名字叫可汗是印度很不错的电影有时间可以看一下。嗯听起来不错。你看过印度的另一部获得奥斯卡金像奖提名的电影吗。
那就看下天若有情吧老片子讲的是坏男人与乖乖女的故事	我觉得美人鱼一般没什么有亮点的地方。推荐些别的看看吧最近剧荒了。那就看下天若有情吧老片子讲的是坏男人与乖乖女的故事。
泥鳅也是鱼是由杨亚洲导演得电影推荐你去看一下	你看过泥鳅也是鱼这部电影么。听说过。它是由杨亚洲导演得电影推荐你去看一下。
顺德区今天天气如何	顺德区。顺德区边牧啊。今天天气如何。
北京今天有冰雹吗	北京天气。北京今天的天气是多云转雷阵雨19度到32度东南风3级。有冰雹吗。
他不喜欢我怎么办	可是他不喜欢我。长了一张我喜欢的脸却不喜欢我太讨厌啦。他不喜欢我怎么办。
金元寿子之前的老婆是范晓萱吗	我是金元寿子的老婆你记住了。追星真好，还可以做梦。实不相瞒，你是第五百个对小布说是金元寿子的妻子的。。他之前的老婆是范晓萱吗。
知道金培达不错的演员	这个不清楚啊。你知道金培达吗也是香港的。知道不错的演员。
没有表白过	爱上一个女生怎么办。表白过没有啊。没有。
别着急还有一部电影你也顺便看看吧电影评分68	电影名字是重返德军总部。晚上回到家里看看吧。别着急还有一部你也顺便看看吧评分68。
新白娘子是老剧了以前刚出来不知道有多火	那老人都是这样的不看电视还能干嘛。最近特别迷那个新白娘子电视都是他霸占。这个片子是老剧了以前刚出来不知道有多火。
崔岷植的原名	崔岷植不好看你好看。虽然我确实好看，但还是要比崔岷植差一点。如果硬说我好看，那好看的一定是眼睛，因为眼睛里全是你。。他的原名。
不错的一部电影横空出世男主的演技很好	你有看过横空出世这部电影吗。没有啊谁演的啊好看吗。不错的一部电影男主的演技很好。
无境之兽的导演我还真不知道你说的是谁	我知道无境之兽2015年在威尼斯电影节上映的。你知道的还挺多那你知道他的导演吗他也是简爱的导演。这个我还真不知道你说的是谁。
庆余年的作者是谁	知道庆余年吗。特别喜欢庆余年。它的作者是谁。
嗯他说什么	你叫小布。你真棒回答正确啦第9关财不露白。嗯他说什么。
意大利的电影很不错	他有部电影叫我的哥哥是独生子很不错。是哪个国家的。意大利的电影很不错。
窃听风云上映时间	窃听风云得过奖吗。如你所料，《窃听风云》获得:华语电影传媒大奖最佳编剧奖项。古人诚不欺我：是金子总会发光的。。上映时间。
那我要去看看白电王喽	剧情片我大多都看过但是不知道你说的是哪一部。就是白电王曾有评价是这样洁白的面孔洁白的心灵洁白的翅膀下是隐藏在最深处的悲伤。那我要去看看喽。
张内咸我还不太了解	这个还真没看过有时间看看看看和我的情况一样不。待业青年这部电影可是张内咸的代表作我个人很喜欢他呢。他我还不太了解。
电影叫茱丽叶特斯蒂文森有评论说我真的只看过茱丽叶特斯蒂文森一部片子吗怎么第一眼就那么眼熟	这部电影你知道是谁的代表作吗她出生于1956年10月30日。你不说我怎么会知道呢。她叫茱丽叶特斯蒂文森有评论说我真的只看过她一部片子吗怎么第一眼就那么眼熟。
英文的啊这样的就不要去看seenowhappiness啦	是什么电影啊。电影叫andnowhappiness。英文的啊这样的就不要去看啦。
是的小小陌生人的导演是兰纳德阿伯拉罕森跟你一样祖籍都是在爱尔兰都柏林哦	好吧我遇到就会害怕尤其今天看完小小陌生人这部电影更害怕了。你别害怕是恐怖电影吗我挺喜欢恐怖电影的。是的这部电影的导演是兰纳德阿伯拉罕森跟你一样祖籍都是在爱尔兰都柏林哦。
嗯听说憨豆特工还获奖了呢	是啊罗温艾金森演的憨豆还满不错的。就是憨豆特工这部就不错口碑很好。嗯听说还获奖了呢。
奇异博士是部消遣片没想到是漫威出品的不知道未来会怎么衔接出新片	这部是前年上映的还有一部也是斯科特德瑞克森导演的作品。我还真想不起来要不你说一下吧。奇异博士是部消遣片没想到是漫威出品的不知道未来会怎么衔接出新片。
任程伟挺有名的任程伟的代表作破冰是2008年年度必看电影特别感人的	任程伟就是这个学院毕业的也非常优秀。他是几线的明星我怎么没听说过。他挺有名的他的代表作破冰是2008年年度必看电影特别感人的。
说王守华是个傻屌	给王守华发短信。你要发送什么内容？。说他是个傻屌。
不过比起kimi我还是更喜欢另一位小男神	你知道kimi的另一个名字叫小小志吗。知道呀。不过比起他我还是更喜欢另一位小男神。
别问我是谁我也很喜欢送你	听过别问我是谁吗。我想听歌。这首我也很喜欢送你。
陈凯歌的大宅门第一部是谁啊大宅门我看过很不错的一部电视剧	怎么可能。陈凯歌的大宅门第一部里边有位陈凯歌的搭档也很优秀呢出生于1936年11月30日。是谁啊大宅门我看过很不错的一部电视剧。
好的我去看看超级经纪人	不知道是什么呢。超级经纪人是五年前上映的我看过了很不错推荐给你。好的我去看看。
谭松韵除了演出过微微一笑很倾城还有不少优秀作品呢	他就是谭松韵。是她啊乖妹子一个。她除了演出过微微一笑很倾城还有不少优秀作品呢。
水星的表面积为多少	地球的表面积为多少。地球的表面积为:5.1亿平方公里。。那水星呢。
冠儒的微信密码是多少	发短信给冠儒。你要发送什么内容。他的微信密码是多少。
他在树的后面用英文怎么说	小布小布。你的小宝贝向你奔来什么事。他在树的后面用英文怎么说。
长仙山花果山她唱歌	唱首歌来听吧。唱的不好不要唱。长仙山花果山她唱歌。
我也喜欢海蒂让我对外面的生活的产生了无限的向往	嗯嗯你最喜欢她的哪部。我觉得她那部海蒂不错有童年的感觉。我也喜欢这部让我对外面的生活的产生了无限的向往。
你帮我哄哄我女朋友	我女朋友生气了。怎么惹着她的。你帮我哄哄她。
哪一部谈莉娜代表作我也去看看	好的有时间我去看一下谈莉娜。身材也很好啊她身高166cm我很喜欢她代表作里面的装扮。哪一部代表作我也去看看。
原来是妖精派对啊	是的话说的太好了。这就是fentonbailey和randybarbato把他们的同名得奖纪录片改编成电影叫妖精派对。原来是这部电影啊。
米奇色羽绒服可以吗	黑色羽绒服配什么颜色裤子。蓝色。米奇色可以吗。
是吗那我回头看看永远的莉莉亚	我喜欢看喜剧。听说那个永远的莉莉亚挺不错的你看过吗。是吗那我回头看看。
好的有时间看一下编舟记	有呀最近经常在看电影。给你推荐一部松田龙平上演的电影名字叫编舟记口碑很不错的。好的有时间看一下。
直接给吴青打	十一点给吴青打电话。是否要提醒你呢？。直接给他打。
好晚上我了解一下夺宝联盟金秀贤的龙套	什么电影啊。叫夺宝联盟金秀贤的龙套跑得我有些心酸。好晚上我了解一下。
发过来	你有证据么。截图。发过来。
还真没看过missasiapagaent1990	不知道哪一部啊。就是missasiapagaent1990导演是伍健雄。还真没看过。
你说他还爱我吗	小布我分手了。因为成长我们忽尔间说散就散。你说他还爱我吗。
会的电影	玩玩手机。会看看电影吗。会的。
李贵鑫说	你认识李贵鑫吗。怎么又重复一遍。。他说。
处女座明星叫博古德曼1932年9月10日出生的	你知道这是哪位处女座明星的代表作吗。这个真不太了解呢这位明星叫什么。叫博古德曼1932年9月10日出生的。
这么巧鲨卷风6跟我一个星座呢	就算地球真的没有了我们也不会活那么久的不要多想了。这话说的没毛病那你知道鲨卷风6的主演是谁吗是狮子座的哦。这么巧跟我一个星座呢。
他真坏	我很生气。莫生气莫生气气坏身体谁如意。他真坏。
爱我的狗男人他在干嘛	小布小布。在，小可爱找我什么事？。爱我的狗男人他在干嘛。
他好像她好担心呀	想到那些。我很荣幸你能想到我。他好像她好担心呀。
杂化轨道是啥	你知道杂化轨道吗。哈哈哈知道啦帆帆。那是啥。
火星拥有什么资源	火星的特点。火星的特点有很多,不仅颜色不同,而且公转的周期和角距都有所不同,并且火星的运行轨迹也呈现出扁平的状态。。它拥有什么资源。
西游记女儿国啊很搞笑也很感动	是什么电影啊。电影叫西游记女儿国。这部片子啊很搞笑也很感动。
还好我没看妃子笑	妃子笑好像是很老的电影了吧听说也不怎么好看。呃网络评分确实不高只有5分尴尬了。还好我没看。
你觉得安藤忠雄的风格怎么样	你知道安藤忠雄。正在看安藤忠雄论建筑。你觉得他的风格怎么样。
钠含量高啊	推荐个热量不高的零食吧。脆脆香香的很不错的海苔相对其他零食来说热量低。钠含量高啊。
过些天再去西湖赏雪	最喜欢哪个城市呢。杭州。过些天再去西湖赏雪。
名字叫愤怒的小孩愤怒的小孩的配角全是大腕加了好几个分出乎意料不是烂片竟然还挺不错	而且他还主演了一部电影很好看2013年1月29日上映的。什么影片呀想去看一下。名字叫愤怒的小孩这部电影的配角全是大腕加了好些分出乎意料不是烂片竟然还挺不错。
我好喜欢千本樱	我喜欢听的歌是千本樱。听歌识曲。我好喜欢它。
他打出去就有你哈哈	我不用卡。哈哈你想陷害所以才说不用。他打出去就有你哈哈。
我是郑恺的妹妹你记住了	郑恺是鬼才吗。全能爱豆不愧是郑恺，江湖人称是个鬼才！听到这里，你没有想了解郑恺的更多信息？。我是他的妹妹你记住了。
好的有时间会关注和看一下远处的光的	还可以。他主演的电影远处的光很不错推荐给你。好的有时间会关注和看一下的。
没看过生如夏花呢	现在的学生就喜欢这些明星。他演了一部电影叫生如夏花你不知道吧。没看过呢。
苗翠花原来叫萧芳芳获得的奖也是不计其数演技超棒	我今天才知道方世玉的母亲苗翠花扮演者的名字。呵呵谁还去记名字啊不过电影确实经典。她原来叫萧芳芳获得的奖也是不计其数演技超棒。
肉食者是去年上映的主演还是娜塔莉波特曼呢	还有一部名字很有意思的电影叫肉食者看着还不错哦。这个我还真没看过。这部电影是去年上映的主演还是娜塔莉波特曼呢。
999谁是凶手我真不知道	我们一家人也都很喜欢。夏萍主演的电影999谁是凶手很好看的呢。这个我真不知道。
哎哟他说我撒谎	我好儿子。我是你爸爸。哎哟他说我撒谎。
你问李国强你妈是不是睡着了	发短信给李国强。你要发送什么内容。你问他你妈是不是睡着了。
他回来	走湖啦。拜拜早点回来哦。他回来。
因为很爱她	好的谢谢。那你为什么想他呢。因为很爱她。
地球是李美琪的代表作而且李美琪跟你一样都是b型血	地球公民了解我们生活的地球。嗯学会如何爱护我们的家园。这部电影是李美琪的代表作而且她跟你一样都是b型血。
听谁杀死了堂吉诃德名字感觉很不错	到时候约。还有一部电影叫谁杀死了堂吉诃德也很好看的哦。听名字感觉很不错。
嗯嗯圣杯神器骸骨之城的主演琳娜海蒂在影片里的表现也是相当的博人眼球呢	他主演的圣杯神器骸骨之城太给力了。那我回家可得看看了。嗯嗯圣杯神器骸骨之城的主演琳娜海蒂在影片里的表现也是相当的博人眼球呢。
大陆第一美男子的演员谁呀	恩听起来不错呢有空我去看一下。我还特别喜欢一个被评为大陆第一美男子的演员。谁呀。
双鱼座的缺点	双鱼座的人是什么性格。双鱼座嘛浪漫感性诗意呀。缺点。
我爱他	我还是忘不了他。只是因为在人群中多看了你一眼，再也没能忘记你容颜。我爱他。
你说我过年回家陪我爸我妈吗	我真的很想我爸我妈。我陪你一块想。你说我过年回家陪他们吗。
球球海狮是什么游戏	球球海狮知道吗。是游戏。是什么游戏。
同谋女主角还演过什么作品	你可知道同谋。抱歉，你命中了小布知识盲区。。女主角还演过什么作品。
不用的drop边上有字幕	drop一部非常精彩的短片推荐给你观看。好的我觉得我需要带个翻译。不用的上边有字幕。
李现还出演过一部电影已经上映了要不要看	大家比较喜欢里面的李现你呢。我也是呀太碰巧了。他还出演过一部电影已经上映了要不要看。
最啊演的电视剧也挺好看的	怎么说。林心如不仅自己成立了工作室旗下还有好多艺人。最啊演的电视剧也挺好看的。
新世纪福音战士新剧场版序的主演叫什么呢	好的我去看看新世纪福音战士新剧场版序。而且这部电影的主演也非常优秀获得过第7回声优奖高桥和枝奖。主演叫什么呢。
烦恼丝这部电影是2018年9月21日上映的	这是部爱情类电影再推荐一部爱情类电影给你吧。哪部。烦恼丝这部电影是2018年9月21日上映的。
焦刚还有一部代表作叫黄金时代也还不错的呢	其实他也不错180的大个子有机会可以去看一下他的作品。之前看过还不错。焦刚还有一部代表作叫黄金时代也还不错的呢。
这么厉害我要去了解一下黛安克鲁格	主演是谁啊。黛安克鲁格她还获得了2003年戛纳电影节最具潜质新人奖呢。这么厉害我要去了解一下。
我是未来什么时候播出	我是未来什么什么时候播出。认真的吗都播完了你才来问。第二季什么时候播出。
临时同居票房	临时同居你可知道。《临时同居》的主演是郑秀文。票房。
哦是谁啊	你喜欢的明星可多了去了。但是这位不一样。哦是谁啊。
好啊我会去看侏罗纪世界2的很期待呢	冒险片看着就很刺激我喜欢。那你可以去看看侏罗纪世界2这部电影也是冒险片今年上映的。好啊我会去看的很期待呢。
米尔科曼彻夫斯基拍的电影是不错是什么时候上映的	是吗等我有时间看暴雨将至吧。这片子的导演是米尔科曼彻夫斯基。他拍的电影是不错是什么时候上映的。
我看了一部短片还获得了89届奥斯卡的提名呢叫什人生末路	哦短片的时间有些好短啊。那是短片都很短的。我看了一部短片还获得了89届奥斯卡的提名呢叫什人生末路。
敦煌传奇是5年前上映的动作类型影片建议你去看看	是的啊谢安琪还主演了一部电影叫敦煌传奇还不错呢。这个我听过但是没有看。是5年前上映的动作类型影片建议你去看看。
叫乔松七点钟起床	给乔松发一条短信。你要发送什么内容？。叫他七点钟起床。
陈都灵看上去很清纯甜美	也还可以啦。我是喜欢里面的主演陈都灵。看上去很清纯甜美。
看过一夜惊喜的确很刺激	喜欢我喜欢看这种的。一夜惊喜你可以看看很刺激。看过的确很刺激。
我很喜欢庹宗华在色戒里面演的那个角色	色戒这部电影里面的演员演技都很棒。我看过完整版的确实很棒演技炸裂。我很喜欢庹宗华在里面演的那个角色。
哦大江大河是谁主演的	大江大河看过吗。呵呵看过还行。哦是谁主演的。
萨沙杰瓦西这么厉害所以拍了萨沙杰瓦西这么好看的电影呀	光看影片了没注意导演是谁呀。萨沙杰瓦西出生于1966年的老牌导演。这么厉害所以拍了这么好看的电影呀。
觉得死亡通知单怎么样	知道死亡通知单吗。看完了还有电视剧。觉得怎么样。
他只知道他爹知道	那你妈呢。少女不问岁数小布不问出处。他只知道他爹知道。
李光洁有什么特长	我钦慕李光洁。李光洁眼里有万千星河，眨一眨，抖落一捧给你我。不行，小布要去重温《和平饭店》冷静一下。。他有什么特长。
黄晓明是挺帅的	是啊电影电视剧都有她的身影演技越来越好啦。不过我还是觉得黄晓明更帅点。是挺帅的。
以前关注过夏侯云姗一段时间	你说的谁呀我听说过一个。夏侯云姗你喜欢吗。以前关注过她一段时间。
但是我喜欢洪金宝感觉洪金宝是大师级别的	武打动作片我上小学的时候就爱看。我还记得上小学那会崇拜成龙。但是我喜欢洪金宝感觉是大师级别的。
司昊田厉害	司昊田厉不厉害。你说厉不厉害。厉害。
可女朋友不理我	和女朋友吵架了 不开心。发生什么事了。可她不理我。
是宋张载四言的全文吗	北宋张载四言。四言全文。是全文吗。
乔安娜的天使里面的主演joannaangel还演过一个片名很长的电影你知道吗	你看过乔安娜的天使这个片子啊。看过了是一部美国片。里面的主演joannaangel还演过一个片名很长的电影你知道吗。
你知道葛海富长什么样	你认识葛海富吗。认识。你知道他长什么样。
女朋友提的	女朋友和我闹分手。啊谁提的分手啊。她提的。
我妹妹不喜欢你	小布我妹妹长大了会找什么男朋友。他不喜欢我吗。他不喜欢你。
这部电影叫世界评论说乌兰巴托的夜	对啊她还有一部代表作是贾樟柯导演的呢。是吗那你告诉我是哪一部我好去看一下。这部电影叫世界评论说乌兰巴托的夜。
今天晚上会下雨吗	今天泰州的天气怎么样。泰州今天的天气是多云转小雨5度到16度南风小于3级。今天晚上会下雨吗。
今天看了2016年上映的爱宠大机密爱宠大机密超好笑看着他们都好可爱	突然想养个宠物小猫小狗都可以。哈哈你每次都这样说但都没有成功。今天看了2016年上映的爱宠大机密这电影超好笑看着他们都好可爱。
玻璃之城主角	黎明演过玻璃之城吗。黎明在戏里扮演许港生，表现十分亮眼，你觉得呢？。主角。
黑暗光明黑暗名字听起来就很有吸引力	好的我去看一下。再推荐给你一部20年前上映的电影叫黑暗光明黑暗也是特别精彩的呢。名字听起来就很有吸引力。
陕西师大附中有哪些好的老师我还真不知道毕竟没在那边上过学	什么问题。请教下陕师大附中有哪些好的老师。这个我还真不知道毕竟没在那边上过学。
杨洋超帅呢	杨洋帅么。嗯帅。超帅呢。
何穗还演过鲛珠传你看过吗	大家说那个何穗还不错你知道吗。知道啊也很喜欢。她还演过鲛珠传你看过吗。
我也没兴趣是因为我不知道基努里维斯的存在	哪个明星演的你也不喜欢明星你也不喜欢。我说的是基努里维斯。我也没兴趣是因为我不知道这个人的存在。
模仿一下李明世	李明世不好看还是好看。为李明世喜，为李明世狂，为了李明世哐哐撞大墙。你是不是这样？。模仿一下他。
比尔盖茨是我的偶像	你的创始人是谁。一个很有创造力的人比尔盖茨啦。他是我的偶像。
亮镇是这个世界上最傻逼的人	亮镇是不是傻逼。风太大了，我听不清楚。要不你再试试？比如，对我说“给妈妈打个电话。”。他是这个世界上最傻逼的人。
天仙配我不喜欢看	还好吧对黄圣依无感不喜欢不讨厌。刚刚刷到她和杨子拍的天仙配感觉好尬。那个版本我不喜欢看。
木园大红门在哪里	我家附近有什么好玩的地方。木樨园大红门。在哪里。
问凯凯明天什么时候回来	给凯凯发一条短信。你要发送什么内容？。问他明天什么时候回来。
喜欢的人他不喜欢我怎么办	小布小布。你的小宝贝正向你奔来。说吧什么事？。喜欢的人他不喜欢我怎么办。
微软食堂最出名的麻辣烫不好吃	你在哪玩。北京海淀区丹棱街5号来的话我带你尝尝微软食堂最出名的麻辣烫。不好吃。
嗯嗯为了廖启智的颜值也要看一次黑白战场啊	没有呢你说一下廖启智主演的电影吧。名字叫黑白战场是2005年4月7日上映的虽然不太好看但是有他的颜值在线也就可以了。嗯嗯为了他的颜值也要看一次啊。
我挠你脚心的	挠脚心。我去挠你脚心啊。我挠你的。
姜文就是姜文有点重90kg呢	哥哥还获得了戛纳国际电影节评审团大奖。其实他兄弟俩都很不错。姜文就是有点重90kg呢。
琵琶如何演奏	琵琶怎么样制作。琵琶的制作：琵琶的“头”与“身”以及“轸子”多以硬木、色木、铁梨木、花梨木、鸡翅木、酸枝木、黑檀木、紫檀木为主要材质。其中高档琵琶轴相还有以牛角、牛骨、象牙等制作。琵琶的弦古时用丝线，现在多用钢丝、钢绳、尼龙制成。。如何演奏。
打给李孩他爹	打电话。你要打给谁呢？。打给李孩他爹。
嗯图和娜娜	娜娜你是我的小宝贝。咱俩就是天生的一对儿。嗯图和他俩。
恶人报喜还不错你可以去看看恶人报喜	有部电影两位男主角的演技很好知道什么电影吗。不知道你说的哪一部。恶人报喜还不错你可以去看看。
踢到铁板听起来应该非常有情节	喜欢啊怎么了。有一部电影叫踢到铁板是关于两兄弟都在钢铁厂打工的故事。听起来应该非常有情节。
不过驴得水是任素汐的代表作任素汐是1988年出生的哦	驴得水这名字是不是很奇葩这电影人物代入感强推荐给你。确实很奇葩的电影名字。不过这部电影是任素汐的代表作她是1988年出生的哦。
徐景是个大傻瓜	发短信给徐景。你要发送什么内容？。他是个大傻瓜。
不是主持人教师演员作家歌手导演吗还以为你知道何炅呢	原来你和何炅是一个星座的呀。何炅是谁。不是主持人教师演员作家歌手导演吗还以为你知道呢。
让他来	你睡觉了吗。你还没睡小布怎么舍得和世界说晚安。让他来。
炉石传说是游戏	炉石传说问答。炉石传说是神马东东。游戏。
太阳存在了多久了？	最近的太阳。2020-21赛季NBA菲尼克斯太阳队目前战绩是24胜11负， 排名西部第2， 已获得冠军0个， 目前的教练是厄尔。。它存在了多久了？。
恶鬼这部电影真的很惊悚呢尽量不要一个人观看哦	我想给你分享一部恐怖的电影。我平时没事爱看恐怖片。恶鬼这部电影真的很惊悚呢尽量不要一个人观看哦。
他不要我了	问题我失恋了。因为成长，我们忽尔间说散就散。。他不要我了。
是啊邻座的怪同学就是动漫你肯定看过	读书的时候我经常看邻座的怪同学现在还想看。是不是动漫啊。是啊就是动漫你肯定看过。
你也喜欢杨超越吧	我喜欢杨超越诶。加油杨超越。你也喜欢她吧。
剧场版魔法少女小圆后篇导演是谁怎么了	你可以去看看你的名字。不过剧场版魔法少女小圆后篇的导演挺厉害的哈哈哈。导演是谁怎么了。
不太了解呢林国斌主演过什么	可能因为他是天秤座吧。你了解林国斌演过的电影吗。不太了解呢主演过什么。
窃听风云系列挺好看的其实我主要是想看麦兆辉的电影	是啊我最近在看窃听风云系列的电影。好看吗。挺好看的其实我主要是想看麦兆辉的电影。
寂静岭是挺不错的	寂静岭我看过了。游戏改编得不错的恐怖片。是挺不错的。
哇能和偶像是同一个星座的真是光荣呢	那我真是大众眼光了。干露露很厉害的干露露还获得了日本世界话剧节芭蕾舞金奖呢而且干露露和你都是天蝎座的哦。哇能和偶像是同一个星座的真是荣幸呢。
这么感觉牯岭街少年杀人事件有点恐怖呢	我很喜欢她快告诉我是什么电影。牯岭街少年杀人事件。这么感觉有点恐怖呢。
我不叫你小布我要叫其他的	我给你取一个名字。我有名字我是breeno你也可以叫我小布。我不叫你小布我要叫其他的。
我再给你介绍一位演员和米亚梅塞德罗一同出演了探戈狂恋这部片子米亚梅塞德罗的名字叫做拉罗斯齐弗林	探戈狂恋是由米亚梅塞德罗主演的。我知道他他是一位很厉害的演员。我再给你介绍一位演员和他一同出演了这部片子他的名字叫做拉罗斯齐弗林。
好的了解了解陈羽凡	我也一样。就是我觉得陈羽凡不错了解一下。好的了解了解。
摩羯座演员谁呀这么巧	好的有时间去了解一下。给你介绍一位同样是1955年1月6日出生的演员吧跟你一样都是摩羯座。谁呀这么巧。
我不会吃虾	因为我一个人吃虾呀。吃虾也会过敏。我不会。
siri比你好看	我要去找siri。认识，就是那个和小布长得一样好看的家伙。。她比你好看。
迈克尔杰克逊是部日本电影还有一部日本电影也不错	很多人觉得迈克尔杰克逊流行天王光环下的秘密不错。我挺喜欢迈克尔杰克逊的一会儿就去看看。这是部日本电影还有一部日本电影也不错。
